ball_one;ball_two;ball_three;ball_four;ball_five;ball_six;bonusball;sum_six_ball;sum_allballs
12;17;18;21;33;37;23;138;161
6;18;27;33;37;45;42;166;208
3;7;11;28;31;43;46;123;169
4;11;16;21;36;40;8;128;136
9;14;22;24;37;44;45;150;195
1;2;9;13;21;34;47;80;127
20;23;36;37;38;39;32;193;225
1;5;18;22;32;45;38;123;161
22;29;30;31;44;45;6;201;207
4;11;12;18;25;39;40;109;149
4;14;25;27;42;45;2;157;159
1;21;28;30;43;45;2;168;170
3;12;13;23;36;47;16;134;150
6;18;36;41;46;47;32;194;226
9;15;25;30;32;34;43;145;188
25;31;32;41;43;46;45;218;263
14;15;29;34;41;46;9;179;188
1;2;10;16;21;32;18;82;100
8;11;29;42;44;46;18;180;198
1;14;18;23;30;32;4;118;122
4;12;25;26;27;44;8;138;146
20;24;27;32;39;43;25;185;210
12;16;23;26;34;45;13;156;169
3;9;11;27;29;47;34;126;160
17;27;30;35;42;47;34;198;232
4;18;26;30;31;37;8;146;154
29;30;36;38;44;45;25;222;247
33;38;39;40;43;45;18;238;256
10;14;21;22;35;44;13;146;159
1;4;15;29;38;40;31;127;158
10;14;33;40;42;45;8;184;192
1;14;22;28;37;45;25;147;172
5;10;17;22;29;36;25;119;144
7;11;28;29;35;40;12;150;162
10;16;17;24;26;42;35;135;170
12;14;22;25;26;40;33;139;172
9;15;28;34;39;46;26;171;197
5;8;16;22;30;31;12;112;124
1;5;12;23;45;46;41;132;173
3;5;6;27;29;39;36;109;145
2;8;15;31;37;44;3;137;140
1;6;14;19;31;47;2;118;120
2;4;14;21;41;42;28;124;152
8;19;21;22;34;47;15;151;166
1;4;16;23;26;35;31;105;136
1;3;26;27;41;47;16;145;161
5;11;16;41;43;47;14;163;177
17;18;19;27;30;46;12;157;169
18;21;27;29;34;47;46;176;222
4;14;20;23;27;37;39;125;164
4;11;18;21;33;35;16;122;138
23;27;39;40;41;42;17;212;229
15;17;23;32;35;45;46;167;213
2;5;8;24;43;47;45;129;174
5;9;13;34;37;40;26;138;164
4;17;23;37;40;44;7;165;172
4;27;37;43;44;46;32;201;233
1;7;20;26;43;45;37;142;179
2;5;7;10;24;46;38;94;132
6;26;31;38;39;47;22;187;209
3;14;17;18;38;47;46;137;183
15;20;25;32;44;47;40;183;223
15;29;34;38;40;43;14;199;213
2;10;12;13;38;40;17;115;132
16;27;34;35;37;45;28;194;222
6;7;13;19;21;45;15;111;126
11;12;21;30;35;38;36;147;183
1;8;31;32;33;39;46;144;190
1;9;22;34;41;43;20;150;170
8;9;26;41;42;44;6;170;176
7;17;21;28;38;41;23;152;175
7;24;27;33;34;40;30;165;195
5;11;15;19;33;40;8;123;131
10;15;18;23;28;33;38;127;165
12;17;22;32;38;39;40;160;200
12;18;29;32;34;44;9;169;178
10;17;42;43;45;47;37;204;241
8;10;14;23;39;47;5;141;146
3;6;18;26;42;47;1;142;143
8;13;21;23;40;44;28;149;177
22;23;24;28;32;41;44;170;214
22;30;33;39;40;45;38;209;247
9;14;16;28;33;38;22;138;160
15;19;24;32;38;40;23;168;191
3;8;10;18;22;30;31;91;122
13;14;28;29;34;47;45;165;210
3;8;10;20;43;44;40;128;168
9;12;22;28;35;47;37;153;190
5;6;16;18;45;47;41;137;178
1;4;16;20;28;36;7;105;112
6;19;21;27;28;36;32;137;169
1;14;17;23;31;35;41;121;162
2;14;28;33;44;47;37;168;205
3;26;27;29;41;45;33;171;204
14;26;27;35;38;45;39;185;224
4;20;30;31;34;38;1;157;158
20;34;36;37;46;47;27;220;247
5;13;15;18;27;30;6;108;114
1;6;18;29;31;42;12;127;139
5;9;14;20;30;36;37;114;151
3;5;12;21;22;39;30;102;132
4;24;30;38;39;42;33;177;210
3;5;16;22;28;41;43;115;158
4;9;13;22;44;47;31;139;170
9;12;15;20;23;26;1;105;106
3;4;7;14;18;47;29;93;122
5;7;8;13;18;25;26;76;102
2;5;7;29;38;42;27;123;150
12;14;16;21;40;47;18;150;168
4;7;10;37;38;45;42;141;183
6;15;16;28;31;41;37;137;174
22;23;27;30;42;46;43;190;233
1;23;25;42;43;46;19;180;199
3;5;16;40;45;47;36;156;192
5;9;12;30;34;39;26;129;155
9;13;33;38;45;46;1;184;185
4;5;12;15;16;31;23;83;106
5;18;34;40;42;44;36;183;219
3;7;18;36;40;42;16;146;162
12;13;20;22;29;34;31;130;161
21;28;32;33;43;47;40;204;244
10;14;25;36;38;47;2;170;172
4;14;23;27;33;38;43;139;182
3;20;25;29;31;34;14;142;156
8;11;17;19;21;39;35;115;150
3;10;11;27;28;33;35;112;147
12;14;25;27;40;44;2;162;164
9;14;15;23;27;38;33;126;159
1;6;11;15;41;44;20;118;138
10;15;22;24;32;42;46;145;191
15;20;23;25;39;46;26;168;194
3;8;21;34;37;47;16;150;166
5;17;18;31;38;47;12;156;168
5;6;15;32;39;47;31;144;175
5;8;19;40;41;44;17;157;174
1;8;11;12;20;26;25;78;103
10;12;13;29;30;35;15;129;144
6;19;32;35;37;47;16;176;192
11;22;27;28;34;36;45;158;203
20;23;26;36;43;44;5;192;197
3;13;23;29;33;38;15;139;154
7;23;30;38;46;47;31;191;222
15;24;28;34;40;45;20;186;206
5;15;16;19;31;37;12;123;135
23;28;33;34;41;45;39;204;243
2;9;15;24;31;33;11;114;125
13;18;30;41;42;44;37;188;225
7;14;20;23;27;46;25;137;162
3;10;17;21;37;46;2;134;136
8;23;31;39;41;45;36;187;223
3;16;20;25;29;33;14;126;140
14;24;25;26;29;40;8;158;166
4;9;15;27;29;34;17;118;135
7;19;33;37;39;42;35;177;212
13;16;20;28;37;47;17;161;178
10;13;24;32;33;42;5;154;159
12;22;23;29;38;44;7;168;175
4;10;14;15;29;43;2;115;117
2;9;21;34;37;44;3;147;150
9;21;27;28;30;41;24;156;180
4;5;7;16;43;47;10;122;132
4;8;14;15;31;34;13;106;119
5;8;11;18;22;36;40;100;140
3;10;16;37;38;42;2;146;148
12;14;22;26;33;45;18;152;170
1;7;10;12;24;34;45;88;133
5;11;18;35;40;42;10;151;161
2;11;26;31;40;47;18;157;175
5;14;27;28;31;44;43;149;192
6;10;16;24;25;46;29;127;156
1;2;8;33;38;41;20;123;143
2;4;10;17;20;41;25;94;119
14;20;24;38;41;45;3;182;185
13;19;20;33;40;43;23;168;191
3;10;12;23;29;45;1;122;123
1;3;20;22;39;44;16;129;145
11;27;29;34;35;40;46;176;222
10;15;19;21;24;37;46;126;172
4;13;16;23;33;42;27;131;158
15;17;23;31;33;41;45;160;205
3;15;20;22;24;45;14;129;143
2;5;13;31;42;44;35;137;172
2;5;16;17;22;23;36;85;121
4;5;23;30;42;47;3;151;154
2;14;18;23;34;39;25;130;155
12;23;30;36;37;38;3;176;179
6;19;22;28;35;40;32;150;182
8;9;14;18;23;38;16;110;126
11;17;24;29;30;47;38;158;196
2;9;12;21;32;46;41;122;163
13;16;18;25;38;41;1;151;152
14;16;26;27;32;36;17;151;168
6;7;19;22;24;46;11;124;135
11;28;29;39;42;44;27;193;220
4;15;20;21;34;39;19;133;152
15;16;20;25;28;37;39;141;180
1;2;11;13;14;44;41;85;126
2;6;8;9;24;39;36;88;124
3;4;15;26;27;47;16;122;138
1;12;27;29;30;35;9;134;143
3;18;28;30;31;47;7;157;164
1;3;7;13;23;25;6;72;78
13;20;37;38;39;47;29;194;223
13;27;32;36;38;39;43;185;228
5;8;18;19;28;34;33;112;145
7;14;17;23;30;45;21;136;157
1;23;27;33;42;44;31;170;201
9;10;21;27;31;35;20;133;153
18;21;29;35;41;43;11;187;198
6;10;16;23;24;37;45;116;161
2;10;22;27;38;39;41;138;179
1;13;17;26;30;35;19;122;141
6;8;13;15;21;30;17;93;110
8;13;17;29;34;37;14;138;152
16;21;24;30;31;43;46;165;211
2;15;24;33;41;42;23;157;180
8;11;12;25;34;39;42;129;171
7;22;27;30;41;42;11;169;180
13;19;22;24;34;40;47;152;199
1;8;10;35;37;42;20;133;153
5;6;8;16;29;46;21;110;131
10;13;23;24;25;44;12;139;151
1;15;16;28;34;45;46;139;185
15;18;25;29;39;40;1;166;167
6;12;28;33;44;45;40;168;208
2;3;7;16;29;37;41;94;135
1;3;22;29;31;37;34;123;157
5;10;13;19;27;28;37;102;139
4;29;30;33;40;42;41;178;219
11;14;22;31;32;33;43;143;186
9;13;34;35;37;41;43;169;212
7;20;28;29;42;46;32;172;204
4;8;23;25;34;35;45;129;174
4;7;26;33;35;38;15;143;158
7;14;17;19;27;31;10;115;125
18;25;30;35;41;44;27;193;220
7;12;35;40;44;46;22;184;206
5;13;16;23;27;35;19;119;138
3;4;19;32;39;46;40;143;183
7;17;30;31;34;42;18;161;179
3;32;34;37;41;43;21;190;211
7;14;24;27;35;38;42;145;187
9;10;34;37;40;47;7;177;184
1;3;12;29;36;44;38;125;163
1;2;3;10;30;45;28;91;119
3;11;12;24;37;39;40;126;166
12;14;17;23;27;46;43;139;182
18;23;29;35;40;46;27;191;218
1;7;9;18;22;33;17;90;107
20;21;25;28;33;39;3;166;169
1;7;10;13;39;47;15;117;132
8;17;21;28;44;46;2;164;166
22;24;26;39;42;47;4;200;204
2;17;18;35;38;43;12;153;165
10;12;21;33;35;39;13;150;163
9;12;26;29;34;40;28;150;178
7;13;14;15;16;33;20;98;118
7;30;35;37;41;42;14;192;206
6;7;17;24;27;44;35;125;160
3;9;17;29;42;43;16;143;159
4;9;10;34;35;46;11;138;149
2;11;22;23;29;45;44;132;176
1;10;14;21;22;39;40;107;147
14;17;26;31;34;43;47;165;212
9;10;23;29;42;47;12;160;172
1;18;19;25;26;42;9;131;140
7;15;23;37;41;43;3;166;169
7;10;18;45;46;47;39;173;212
2;3;22;25;31;34;37;117;154
2;6;13;21;41;46;27;129;156
1;3;7;27;31;44;19;113;132
14;15;16;19;38;46;6;148;154
3;19;21;29;31;35;22;138;160
1;9;10;16;19;30;12;85;97
3;6;17;28;35;42;37;131;168
3;9;11;27;30;47;42;127;169
4;9;12;14;17;20;18;76;94
3;4;8;10;11;46;12;82;94
3;5;16;30;46;47;37;147;184
4;6;16;34;38;39;42;137;179
6;12;13;23;31;34;15;119;134
14;26;36;37;40;45;38;198;236
7;33;34;37;45;46;42;202;244
6;9;11;27;34;42;14;129;143
19;30;32;33;35;46;3;195;198
15;16;18;23;39;45;22;156;178
7;10;18;26;37;40;4;138;142
2;14;26;33;37;47;38;159;197
7;13;18;26;27;28;9;119;128
1;2;30;41;42;43;25;159;184
5;20;21;24;34;45;22;149;171
1;5;19;24;27;42;44;118;162
2;9;23;34;35;38;41;141;182
1;19;20;29;31;44;11;144;155
9;15;17;24;41;43;37;149;186
15;16;17;18;35;43;21;144;165
16;24;31;39;43;47;17;200;217
8;9;10;17;20;37;24;101;125
21;29;31;38;41;42;12;202;214
9;14;15;18;25;34;44;115;159
3;4;20;21;37;42;17;127;144
1;8;14;15;45;47;32;130;162
7;8;12;22;36;46;31;131;162
1;8;11;22;28;32;35;102;137
1;5;6;12;22;46;33;92;125
6;15;20;29;38;44;41;152;193
14;24;30;38;40;45;36;191;227
8;19;24;29;42;45;7;167;174
11;22;31;36;44;46;42;190;232
13;16;20;39;42;45;31;175;206
5;7;8;22;27;31;2;100;102
2;13;17;21;28;37;11;118;129
7;21;22;29;31;46;11;156;167
1;15;22;27;31;34;42;130;172
6;9;13;14;27;45;33;114;147
6;7;21;37;46;47;34;164;198
8;15;30;32;35;46;39;166;205
8;11;32;36;46;47;34;180;214
5;7;18;28;37;40;38;135;173
11;12;28;35;37;44;30;167;197
5;12;24;36;37;42;4;156;160
3;10;12;20;29;46;32;120;152
7;8;9;15;27;29;33;95;128
26;27;35;40;41;42;7;211;218
4;9;16;17;21;41;36;108;144
8;14;28;29;35;44;30;158;188
3;8;12;18;22;32;17;95;112
15;30;31;33;39;42;3;190;193
4;22;30;37;45;47;17;185;202
5;20;25;27;30;31;26;138;164
3;4;5;19;26;43;24;100;124
3;27;38;40;43;46;12;197;209
7;23;27;28;37;44;5;166;171
3;16;21;29;36;47;35;152;187
2;6;11;13;20;30;38;82;120
2;8;25;33;39;42;43;149;192
5;16;37;43;44;46;7;191;198
2;14;21;39;42;45;28;163;191
3;11;24;26;29;47;13;140;153
6;25;29;33;42;46;5;181;186
19;22;24;30;38;45;46;178;224
9;18;20;27;38;39;29;151;180
4;6;12;20;40;43;21;125;146
11;26;32;36;42;47;34;194;228
6;26;27;32;45;47;9;183;192
5;21;25;29;41;43;31;164;195
11;12;19;27;30;38;16;137;153
1;10;22;28;44;47;14;152;166
1;7;10;17;35;37;43;107;150
11;13;14;16;31;38;5;123;128
6;15;22;30;39;45;16;157;173
5;22;29;38;40;44;20;178;198
3;11;14;23;36;45;26;132;158
5;10;14;22;25;31;15;107;122
5;6;14;19;22;30;24;96;120
1;12;23;32;36;40;2;144;146
13;19;30;36;41;47;9;186;195
9;17;19;29;37;41;12;152;164
8;16;20;22;37;47;13;150;163
18;30;31;32;33;42;19;186;205
9;12;19;20;29;36;7;125;132
5;14;15;24;27;41;25;126;151
8;9;12;20;28;34;47;111;158
2;7;33;35;40;42;10;159;169
4;18;30;35;40;45;34;172;206
8;14;18;20;23;29;5;112;117
1;2;17;19;38;47;13;124;137
19;20;28;30;33;37;25;167;192
2;17;24;25;35;40;36;143;179
3;5;13;18;29;40;32;108;140
4;10;13;22;25;31;30;105;135
10;11;15;16;22;46;27;120;147
12;27;30;33;38;40;34;180;214
15;19;22;35;36;45;11;172;183
23;25;33;39;42;46;24;208;232
8;14;17;25;28;39;35;131;166
1;10;30;31;42;47;25;161;186
9;26;27;29;31;47;30;169;199
20;21;23;34;39;43;4;180;184
8;16;18;23;35;40;39;140;179
4;6;16;18;27;39;45;110;155
2;5;23;31;37;39;4;137;141
7;16;21;27;30;31;26;132;158
2;9;13;19;21;45;38;109;147
2;12;22;24;33;41;10;134;144
2;7;15;20;21;23;45;88;133
17;19;29;31;37;41;34;174;208
1;4;25;31;32;38;45;131;176
1;2;7;33;34;40;6;117;123
29;32;33;35;36;44;42;209;251
6;8;19;20;38;46;23;137;160
3;8;15;22;25;27;20;100;120
2;8;14;18;39;44;16;125;141
17;20;22;24;25;40;18;148;166
5;14;28;29;32;38;31;146;177
15;16;18;26;27;38;43;140;183
1;21;33;37;38;40;8;170;178
31;38;39;40;42;47;43;237;280
5;13;15;23;36;45;28;137;165
9;15;29;36;44;47;34;180;214
10;11;18;27;28;42;38;136;174
1;4;5;16;39;47;38;112;150
4;16;18;24;32;35;46;129;175
1;8;18;25;39;41;28;132;160
15;17;21;24;28;36;33;141;174
4;7;17;19;27;34;9;108;117
9;16;27;41;42;47;4;182;186
7;11;26;30;45;47;1;166;167
21;31;32;43;44;47;24;218;242
5;13;14;23;31;34;1;120;121
2;3;17;21;34;39;5;116;121
8;10;11;25;28;32;35;114;149
2;10;12;14;31;46;42;115;157
9;13;16;27;32;33;44;130;174
2;8;9;16;27;43;14;105;119
18;23;25;26;42;43;2;177;179
9;16;25;31;38;43;13;162;175
15;18;24;28;33;47;43;165;208
4;6;16;18;26;32;10;102;112
19;24;31;36;38;42;14;190;204
9;26;27;30;42;44;17;178;195
3;11;14;24;30;35;12;117;129
1;2;4;22;38;40;29;107;136
7;19;20;32;34;43;45;155;200
2;8;20;25;33;45;7;133;140
1;4;5;6;18;47;35;81;116
7;11;18;23;28;40;37;127;164
5;12;18;19;29;39;10;122;132
1;16;17;32;34;35;5;135;140
7;19;30;31;37;42;35;166;201
3;12;19;23;37;40;31;134;165
7;16;17;25;31;33;39;129;168
1;19;22;26;44;45;35;157;192
2;7;10;27;29;37;40;112;152
17;20;26;28;36;47;42;174;216
7;12;20;23;25;41;38;128;166
7;18;29;32;34;41;20;161;181
1;6;13;24;37;40;23;121;144
8;14;20;21;41;44;9;148;157
1;5;27;28;32;45;7;138;145
5;10;18;23;36;46;40;138;178
5;6;24;30;38;47;27;150;177
11;31;32;33;38;45;37;190;227
7;16;18;20;24;37;13;122;135
11;13;19;26;38;41;29;148;177
6;10;15;25;34;45;42;135;177
3;20;31;32;43;46;19;175;194
12;15;24;29;33;46;22;159;181
9;14;32;34;40;42;22;171;193
7;10;20;22;40;46;3;145;148
5;6;19;20;24;29;39;103;142
4;9;17;20;23;33;19;106;125
8;10;22;31;36;37;43;144;187
15;31;33;34;36;43;39;192;231
2;5;12;34;41;47;29;141;170
6;16;21;22;30;45;8;140;148
11;17;29;30;38;42;16;167;183
11;32;39;41;42;44;9;209;218
4;16;33;39;43;47;19;182;201
7;8;19;29;36;47;17;146;163
3;7;17;21;22;28;2;98;100
1;15;24;31;35;36;19;142;161
3;12;16;21;39;44;47;135;182
1;16;24;28;39;40;29;148;177
13;17;18;25;26;27;12;126;138
8;18;23;29;30;31;47;139;186
7;9;16;26;40;45;13;143;156
7;14;18;24;25;31;29;119;148
2;7;9;35;41;45;22;139;161
9;10;11;22;30;42;41;124;165
9;16;31;35;37;43;34;171;205
1;8;28;38;40;46;33;161;194
1;4;6;16;18;27;28;72;100
16;22;30;35;36;47;13;186;199
9;11;18;24;30;44;46;136;182
7;9;15;30;37;45;23;143;166
3;11;32;36;37;38;1;157;158
11;13;21;31;32;42;16;150;166
6;12;18;20;41;42;13;139;152
2;15;19;26;37;38;39;137;176
2;12;17;29;32;38;20;130;150
5;9;27;36;38;47;31;162;193
27;32;44;45;46;47;24;241;265
3;10;15;17;34;39;31;118;149
2;16;19;26;28;29;37;120;157
2;6;9;31;41;47;43;136;179
10;21;22;26;42;46;35;167;202
11;13;34;38;40;47;21;183;204
13;14;22;24;25;42;7;140;147
6;7;17;20;25;29;34;104;138
18;21;22;23;24;36;45;144;189
2;12;24;31;34;43;47;146;193
2;4;11;22;25;34;7;98;105
8;12;13;16;19;24;15;92;107
33;36;39;42;45;47;38;242;280
6;10;19;21;43;44;3;143;146
2;8;10;23;27;29;5;99;104
1;12;34;43;45;47;27;182;209
8;10;11;16;40;42;38;127;165
6;10;23;28;37;41;18;145;163
7;20;25;27;41;45;35;165;200
1;7;9;27;35;42;44;121;165
4;5;17;25;36;41;43;128;171
30;36;37;39;43;44;13;229;242
2;6;21;23;29;44;41;125;166
1;5;24;34;39;41;20;144;164
1;19;31;33;37;39;41;160;201
3;8;20;27;28;39;14;125;139
2;13;19;26;29;46;40;135;175
12;14;27;31;37;42;30;163;193
2;9;19;28;32;43;47;133;180
2;15;18;30;33;40;6;138;144
1;16;27;32;35;45;28;156;184
13;27;36;39;41;46;16;202;218
20;25;28;32;38;39;9;182;191
11;21;22;27;30;43;8;154;162
7;9;12;15;28;45;35;116;151
2;11;24;28;37;47;35;149;184
5;10;27;30;32;45;17;149;166
4;6;9;20;29;45;32;113;145
9;18;24;26;27;35;46;139;185
4;17;22;40;42;46;11;171;182
2;5;8;14;40;42;7;111;118
1;2;20;27;32;38;3;120;123
2;7;16;17;27;47;41;116;157
2;19;31;40;43;46;5;181;186
12;16;17;18;25;35;40;123;163
6;7;15;17;20;45;19;110;129
5;6;14;24;26;29;20;104;124
1;2;10;25;38;41;15;117;132
6;9;11;16;19;29;22;90;112
8;14;16;34;35;42;13;149;162
5;10;20;35;43;44;17;157;174
10;17;18;29;37;43;46;154;200
10;11;12;15;18;19;35;85;120
3;16;29;30;41;43;9;162;171
5;13;16;18;19;40;44;111;155
6;11;17;20;28;34;25;116;141
6;17;18;30;40;43;46;154;200
11;14;15;27;29;37;44;133;177
8;10;18;20;28;44;4;128;132
2;4;5;27;40;47;43;125;168
1;10;13;18;27;40;6;109;115
22;35;36;41;44;45;3;223;226
15;28;39;40;42;43;9;207;216
6;9;17;33;44;47;37;156;193
3;11;32;33;37;44;24;160;184
4;5;9;12;29;38;22;97;119
4;11;24;40;42;43;9;164;173
7;10;16;40;44;45;33;162;195
1;4;27;29;42;45;3;148;151
6;16;23;28;32;35;4;140;144
4;6;15;21;22;42;36;110;146
10;15;18;20;32;46;5;141;146
15;16;19;20;26;29;34;125;159
1;10;15;18;30;44;28;118;146
4;32;34;35;43;47;31;195;226
1;15;31;42;44;47;7;180;187
22;28;37;38;41;42;31;208;239
16;18;27;31;39;45;44;176;220
8;15;17;22;34;38;10;134;144
4;8;12;15;25;40;47;104;151
19;20;24;31;43;47;3;184;187
3;8;14;18;37;41;34;121;155
4;5;11;17;34;42;13;113;126
2;28;34;36;45;46;9;191;200
14;21;23;25;30;34;17;147;164
2;5;17;27;34;45;4;130;134
1;9;15;23;33;38;29;119;148
4;5;7;14;18;31;28;79;107
2;10;28;38;44;46;1;168;169
1;9;16;34;37;46;31;143;174
14;22;37;40;43;45;13;201;214
9;27;30;38;40;46;14;190;204
2;3;6;22;25;42;34;100;134
2;10;27;38;39;43;9;159;168
4;8;20;23;29;41;6;125;131
3;10;21;25;28;34;19;121;140
7;13;26;36;39;42;18;163;181
4;14;21;28;35;36;25;138;163
9;18;23;27;31;38;30;146;176
4;6;12;13;15;31;14;81;95
2;8;16;24;33;42;47;125;172
10;11;21;23;25;44;35;134;169
7;8;22;35;39;46;31;157;188
1;15;17;34;39;46;12;152;164
10;14;22;32;34;40;27;152;179
7;10;19;29;39;44;45;148;193
2;12;21;22;30;37;10;124;134
10;22;27;37;41;42;21;179;200
3;4;14;25;42;45;17;133;150
1;4;7;14;15;42;37;83;120
21;25;26;28;33;47;30;180;210
6;7;11;17;23;33;21;97;118
10;12;13;19;43;45;5;142;147
3;6;17;23;27;29;5;105;110
14;18;25;27;33;44;38;161;199
10;14;26;37;42;47;2;176;178
2;11;14;28;29;34;37;118;155
2;15;25;43;45;46;16;176;192
10;19;23;28;31;32;6;143;149
9;18;22;25;43;44;6;161;167
5;6;10;14;40;41;16;116;132
15;21;28;32;36;47;39;179;218
3;14;22;38;45;46;16;168;184
3;8;27;32;39;47;1;156;157
1;10;13;14;16;30;32;84;116
1;4;12;31;37;39;18;124;142
1;6;17;25;31;38;29;118;147
8;9;16;26;32;47;35;138;173
3;7;17;24;26;29;40;106;146
2;5;7;16;46;47;15;123;138
3;9;13;27;38;44;14;134;148
5;7;10;16;30;46;32;114;146
12;16;22;36;40;43;4;169;173
3;5;14;30;40;43;45;135;180
5;8;9;10;15;29;17;76;93
1;5;8;19;20;28;3;81;84
3;8;15;25;39;45;28;135;163
5;7;10;18;41;47;44;128;172
3;12;15;19;23;32;20;104;124
10;11;36;41;44;46;45;188;233
4;7;19;22;25;41;8;118;126
8;13;16;18;30;31;39;116;155
1;21;34;36;38;40;5;170;175
8;12;13;28;34;46;44;141;185
1;15;17;31;36;45;18;145;163
4;9;27;31;38;39;10;148;158
4;8;26;28;34;38;30;138;168
5;6;14;16;32;43;27;116;143
7;26;34;39;41;42;31;189;220
3;9;22;25;27;31;23;117;140
6;12;15;17;32;40;21;122;143
2;6;21;26;43;45;12;143;155
7;9;17;20;26;27;40;106;146
7;20;22;33;35;42;41;159;200
10;14;22;24;26;44;12;140;152
1;5;21;24;30;42;38;123;161
5;17;19;20;29;32;23;122;145
5;16;18;23;35;42;8;139;147
3;4;22;33;37;45;15;144;159
2;8;18;21;28;43;5;120;125
9;26;33;37;40;44;42;189;231
8;9;17;33;36;40;15;143;158
3;7;11;33;37;42;39;133;172
12;14;18;22;32;39;21;137;158
11;33;34;39;41;44;40;202;242
6;7;24;37;38;40;1;152;153
7;10;13;24;27;35;45;116;161
4;7;18;23;36;38;5;126;131
1;20;24;25;37;38;6;145;151
2;10;21;28;40;43;8;144;152
2;12;14;18;36;43;22;125;147
6;13;16;29;34;42;27;140;167
1;2;7;22;35;45;4;112;116
7;14;22;30;35;41;5;149;154
11;20;30;34;36;39;10;170;180
10;14;26;39;40;43;21;172;193
10;17;20;31;33;38;27;149;176
11;16;21;27;29;35;43;139;182
7;27;35;39;43;44;15;195;210
3;9;14;32;33;36;19;127;146
8;28;35;40;41;43;32;195;227
7;18;24;32;37;40;21;158;179
6;21;23;28;30;32;39;140;179
12;15;16;31;38;40;27;152;179
18;19;28;32;35;44;29;176;205
10;14;29;34;39;42;38;168;206
2;5;13;17;32;34;45;103;148
6;13;18;24;29;41;45;131;176
1;7;18;28;30;36;6;120;126
3;9;14;18;35;38;40;117;157
3;17;18;29;35;37;13;139;152
13;20;22;28;33;39;40;155;195
6;12;27;35;36;42;41;158;199
1;15;17;21;30;33;29;117;146
6;8;25;29;31;42;11;141;152
2;4;22;26;30;36;7;120;127
30;31;32;35;37;40;44;205;249
1;17;23;29;30;44;42;144;186
2;10;18;26;39;43;7;138;145
1;12;29;34;39;41;14;156;170
6;17;20;24;28;38;11;133;144
12;21;29;32;36;38;45;168;213
2;6;8;34;36;40;35;126;161
2;4;6;20;21;45;37;98;135
3;21;22;23;30;45;25;144;169
5;8;19;34;44;45;18;155;173
4;29;32;35;37;39;23;176;199
3;4;6;9;23;26;32;71;103
12;27;28;39;41;45;25;192;217
2;3;8;16;32;44;36;105;141
4;5;6;11;35;40;10;101;111
19;21;24;25;30;32;39;151;190
6;8;10;24;30;43;11;121;132
9;10;18;20;24;26;35;107;142
2;6;8;13;30;44;45;103;148
2;15;21;30;32;34;36;134;170
1;9;12;38;43;44;28;147;175
2;16;22;25;35;40;18;140;158
8;13;22;23;43;45;33;154;187
5;6;9;17;35;41;14;113;127
6;7;25;30;37;45;8;150;158
4;7;26;29;39;42;1;147;148
7;8;21;26;29;42;37;133;170
6;7;16;22;40;45;23;136;159
1;13;15;22;24;37;26;112;138
1;2;6;25;30;42;40;106;146
1;6;32;37;41;43;13;160;173
2;16;19;26;27;31;30;121;151
2;13;15;31;33;42;24;136;160
12;20;21;33;35;44;31;165;196
13;16;31;43;44;45;23;192;215
4;5;14;25;28;31;23;107;130
1;14;15;23;27;44;12;124;136
1;3;8;11;14;34;40;71;111
7;15;24;29;35;43;41;153;194
5;8;12;18;23;32;20;98;118
4;12;17;32;34;38;16;137;153
12;17;19;25;38;44;28;155;183
20;26;27;32;40;41;5;186;191
1;7;20;25;33;45;41;131;172
9;14;15;22;24;43;40;127;167
9;12;18;19;31;44;1;133;134
14;31;32;34;35;40;20;186;206
3;6;7;12;14;38;35;80;115
12;19;30;38;40;43;8;182;190
1;10;15;21;22;40;18;109;127
7;25;28;30;32;33;19;155;174
6;14;22;28;37;44;2;151;153
9;15;18;21;34;35;42;132;174
19;24;32;33;37;43;35;188;223
1;10;34;36;41;42;18;164;182
4;27;37;39;40;45;42;192;234
10;12;14;15;31;36;40;118;158
5;9;15;31;35;43;23;138;161
9;14;16;20;23;32;29;114;143
7;10;15;18;25;31;26;106;132
2;4;9;12;28;31;35;86;121
1;6;8;15;38;39;22;107;129
22;34;36;40;44;45;15;221;236
1;2;23;24;26;29;13;105;118
14;21;24;26;31;38;10;154;164
4;11;16;33;43;45;10;152;162
9;17;27;38;39;42;20;172;192
7;12;16;27;37;38;28;137;165
6;7;27;33;35;40;29;148;177
8;16;23;30;38;45;34;160;194
5;6;25;28;38;45;41;147;188
9;22;37;40;42;44;25;194;219
7;9;10;39;42;43;38;150;188
12;18;24;29;34;45;30;162;192
2;3;4;19;33;38;16;99;115
2;6;10;22;29;38;37;107;144
4;6;17;35;37;39;45;138;183
3;4;18;19;26;42;21;112;133
8;18;22;24;26;38;16;136;152
12;17;19;22;28;43;36;141;177
6;20;29;31;35;42;33;163;196
3;7;14;33;36;41;25;134;159
3;6;10;27;40;42;39;128;167
1;6;8;15;26;28;29;84;113
6;9;16;21;28;41;24;121;145
1;4;10;13;14;17;19;59;78
4;5;7;18;24;32;17;90;107
2;8;11;14;17;36;18;88;106
6;12;14;16;33;43;2;124;126
10;11;21;35;37;42;43;156;199
5;8;11;14;23;34;10;95;105
3;6;10;30;37;45;32;131;163
10;13;23;36;40;42;5;164;169
10;21;25;28;34;45;30;163;193
2;5;20;30;37;39;6;133;139
12;16;18;21;31;45;35;143;178
16;21;22;26;33;35;45;153;198
18;22;23;26;32;42;35;163;198
2;9;10;18;23;35;7;97;104
3;7;8;15;28;31;21;92;113
16;25;31;39;40;43;1;194;195
1;15;20;27;41;42;44;146;190
6;7;13;34;44;45;39;149;188
1;12;16;26;27;29;41;111;152
6;14;15;23;24;31;26;113;139
5;11;12;17;42;44;8;131;139
19;26;27;28;32;39;31;171;202
7;12;15;20;25;33;13;112;125
16;22;31;33;34;43;20;179;199
3;11;22;28;35;37;27;136;163
2;11;14;25;30;34;27;116;143
2;3;20;29;39;43;37;136;173
4;10;11;16;17;35;38;93;131
5;8;9;30;33;45;10;130;140
2;18;19;20;21;36;27;116;143
23;25;30;32;34;39;4;183;187
1;3;12;19;23;37;11;95;106
14;17;27;29;30;44;4;161;165
3;12;29;38;41;43;1;166;167
8;9;12;16;29;38;10;112;122
3;5;9;13;25;42;39;97;136
4;12;15;27;36;43;21;137;158
3;8;11;23;27;33;36;105;141
3;9;13;20;21;41;14;107;121
10;12;20;21;27;39;41;129;170
10;17;19;26;36;40;43;148;191
9;21;24;33;35;36;10;158;168
2;13;22;24;32;33;25;126;151
4;14;17;19;36;42;34;132;166
12;14;23;31;32;44;21;156;177
2;8;16;18;30;45;43;119;162
1;8;15;25;29;44;32;122;154
1;16;24;29;41;44;7;155;162
26;32;35;38;39;42;12;212;224
8;23;24;27;35;43;30;160;190
3;13;15;22;26;30;9;109;118
3;9;12;15;31;33;20;103;123
8;11;20;34;36;42;7;151;158
10;26;37;39;42;44;30;198;228
2;11;17;40;42;43;41;155;196
2;21;28;29;37;43;31;160;191
7;11;25;28;30;40;19;141;160
9;10;23;25;32;38;30;137;167
4;11;17;28;39;45;10;144;154
16;26;29;30;36;41;21;178;199
8;12;19;24;28;42;18;133;151
4;5;9;20;27;31;34;96;130
6;10;18;26;27;34;15;121;136
14;16;20;22;31;43;24;146;170
4;9;24;25;29;44;39;135;174
1;11;14;16;18;23;13;83;96
2;12;15;29;34;35;16;127;143
2;3;6;14;24;26;38;75;113
7;9;21;29;30;36;13;132;145
1;10;17;18;43;44;24;133;157
1;18;22;26;35;40;17;142;159
5;14;16;26;34;40;15;135;150
4;5;15;25;28;33;35;110;145
2;7;12;15;26;28;45;90;135
9;11;17;24;33;41;36;135;171
2;21;24;32;36;40;20;155;175
11;25;27;28;35;45;18;171;189
12;22;25;32;39;40;1;170;171
8;12;23;24;28;41;29;136;165
4;12;13;23;36;38;21;126;147
1;6;9;15;18;44;25;93;118
12;24;26;34;35;42;44;173;217
10;23;28;33;34;36;29;164;193
2;19;34;37;39;41;23;172;195
2;10;27;33;36;41;39;149;188
2;11;16;26;31;36;15;122;137
24;27;28;29;36;37;6;181;187
18;21;34;36;40;42;3;191;194
22;25;29;30;35;44;20;185;205
1;5;15;22;25;39;40;107;147
6;11;25;33;40;43;12;158;170
31;34;39;42;44;45;32;235;267
10;34;35;37;43;44;42;203;245
5;6;11;25;30;41;28;118;146
13;25;26;41;42;43;8;190;198
1;3;4;7;27;34;36;76;112
17;20;21;28;31;37;3;154;157
7;13;21;31;36;42;15;150;165
2;22;24;26;38;42;28;154;182
1;17;22;23;40;43;13;146;159
19;22;27;33;40;44;43;185;228
15;31;35;38;40;45;11;204;215
2;6;9;13;30;36;33;96;129
4;14;23;35;38;41;9;155;164
13;17;26;33;36;45;25;170;195
12;13;18;24;39;44;29;150;179
4;10;16;22;40;42;15;134;149
12;15;17;30;33;45;22;152;174
2;4;9;21;22;38;43;96;139
11;28;29;32;34;41;27;175;202
1;5;17;22;35;43;40;123;163
6;7;28;30;35;45;18;151;169
3;13;14;21;35;42;33;128;161
3;21;28;38;39;41;27;170;197
6;9;21;31;33;42;11;142;153
8;9;13;14;20;36;6;100;106
3;24;32;33;40;42;19;174;193
3;4;11;12;36;44;1;110;111
6;12;26;27;32;38;44;141;185
2;14;15;19;27;31;7;108;115
3;12;18;25;41;42;38;141;179
7;26;31;33;42;45;39;184;223
1;8;15;19;26;36;39;105;144
5;7;23;26;31;45;4;137;141
6;11;19;23;32;41;16;132;148
11;13;17;23;28;40;6;132;138
1;3;20;31;34;38;33;127;160
6;9;11;12;21;29;32;88;120
9;17;36;38;40;43;6;183;189
3;7;26;30;39;45;2;150;152
3;5;14;16;22;26;45;86;131
1;2;18;30;34;36;5;121;126
12;13;25;36;41;45;28;172;200
7;20;22;25;28;32;29;134;163
4;11;19;26;35;40;7;135;142
11;13;15;20;28;33;29;120;149
3;10;25;38;43;44;23;163;186
1;6;8;10;13;14;20;52;72
1;8;15;19;23;33;5;99;104
1;5;7;20;31;40;21;104;125
7;9;12;25;27;45;26;125;151
2;13;20;23;26;30;39;114;153
3;12;18;27;38;42;29;140;169
1;11;13;14;15;37;30;91;121
3;7;25;34;40;44;36;153;189
12;23;25;28;29;34;20;151;171
6;9;16;23;26;27;11;107;118
4;6;26;29;33;40;41;138;179
1;2;7;15;20;27;11;72;83
3;11;20;23;33;36;31;126;157
4;11;23;30;37;44;32;149;181
3;4;16;19;37;45;7;124;131
4;5;24;25;28;42;10;128;138
2;14;22;24;29;41;44;132;176
3;10;24;26;32;44;6;139;145
1;10;12;27;29;45;44;124;168
4;9;13;18;37;40;42;121;163
3;10;14;17;22;37;1;103;104
4;12;14;16;21;34;22;101;123
3;11;22;26;33;41;25;136;161
6;8;22;24;34;38;21;132;153
6;15;23;27;33;44;10;148;158
3;10;24;30;31;39;28;137;165
5;9;11;13;28;43;36;109;145
3;9;12;25;40;42;33;131;164
2;11;30;36;40;44;42;163;205
1;4;15;16;29;33;8;98;106
6;7;8;22;24;41;35;108;143
5;7;9;21;26;40;15;108;123
14;21;25;28;31;36;19;155;174
4;10;21;32;43;44;11;154;165
12;18;21;25;38;45;35;159;194
4;9;16;28;32;38;1;127;128
10;11;19;22;41;44;2;147;149
18;22;23;32;35;37;3;167;170
5;8;19;31;34;45;9;142;151
1;5;20;38;40;42;3;146;149
5;10;15;27;35;43;1;135;136
2;7;19;23;33;43;28;127;155
1;9;16;22;23;44;41;115;156
10;16;25;35;39;41;43;166;209
8;10;23;25;37;38;9;141;150
1;10;32;35;39;45;33;162;195
1;2;10;12;27;36;11;88;99
11;12;21;38;41;43;10;166;176
4;15;23;24;26;45;18;137;155
17;18;19;31;32;44;29;161;190
8;14;25;36;38;40;31;161;192
1;13;29;34;42;43;28;162;190
4;9;18;38;39;40;22;148;170
2;5;15;18;37;40;20;117;137
2;5;18;20;28;37;16;110;126
9;21;26;31;39;42;5;168;173
17;21;31;34;35;37;24;175;199
3;7;9;12;24;28;20;83;103
6;10;12;26;28;30;8;112;120
1;7;14;23;31;34;35;110;145
3;6;10;13;14;34;15;80;95
2;4;14;15;20;21;10;76;86
12;17;22;32;34;41;5;158;163
2;9;11;20;33;36;14;111;125
10;11;12;22;37;40;9;132;141
5;6;11;20;29;39;32;110;142
1;6;7;16;17;41;8;88;96
3;11;23;24;27;38;16;126;142
6;9;10;22;32;43;25;122;147
8;26;27;28;32;37;25;158;183
7;8;11;12;42;44;3;124;127
2;11;13;18;20;30;6;94;100
5;6;17;21;38;41;39;128;167
4;5;6;35;38;42;27;130;157
4;10;18;33;35;38;29;138;167
1;13;16;17;20;22;24;89;113
4;12;14;37;41;43;26;151;177
25;26;28;35;36;40;39;190;229
2;12;13;15;32;42;27;116;143
2;6;12;13;26;29;21;88;109
28;34;37;39;41;43;22;222;244
7;12;24;36;43;45;34;167;201
3;19;21;34;36;42;40;155;195
2;6;15;30;33;37;32;123;155
5;18;30;41;44;45;37;183;220
7;10;11;15;37;40;42;120;162
6;18;23;24;34;38;5;143;148
11;17;20;28;36;45;14;157;171
2;11;12;16;22;27;33;90;123
4;12;25;27;41;44;33;153;186
6;18;23;24;31;32;1;134;135
1;12;16;22;38;42;32;131;163
4;7;15;34;39;40;35;139;174
15;21;23;25;44;45;10;173;183
1;2;6;14;31;42;37;96;133
2;12;31;37;39;45;26;166;192
2;4;11;18;27;44;19;106;125
3;21;24;32;34;37;23;151;174
1;15;26;32;33;41;35;148;183
1;8;15;21;24;25;42;94;136
9;27;31;39;42;45;1;193;194
1;6;20;27;35;40;10;129;139
5;12;17;19;40;41;10;134;144
5;17;18;22;34;37;35;133;168
5;22;27;28;37;41;8;160;168
9;10;16;26;38;43;15;142;157
6;8;12;32;35;39;4;132;136
4;5;6;15;20;25;19;75;94
1;2;14;24;25;30;27;96;123
8;21;38;41;42;45;43;195;238
4;23;32;35;37;44;3;175;178
2;7;12;14;23;35;27;93;120
2;22;35;38;40;44;23;181;204
3;10;19;26;31;36;16;125;141
6;23;25;26;28;38;17;146;163
5;9;13;17;24;38;21;106;127
12;21;33;38;41;44;27;189;216
8;9;10;28;30;43;44;128;172
2;4;7;17;19;32;18;81;99
2;8;21;38;39;43;25;151;176
7;16;25;38;42;44;30;172;202
4;8;12;18;35;45;1;122;123
18;20;32;33;35;44;15;182;197
1;7;24;31;33;38;35;134;169
10;19;29;30;41;43;21;172;193
2;3;9;25;33;38;32;110;142
5;11;25;27;30;40;41;138;179
3;4;5;12;20;31;16;75;91
2;5;14;22;38;42;32;123;155
12;19;21;31;39;42;2;164;166
4;15;16;33;42;45;2;155;157
10;11;36;40;42;45;17;184;201
6;12;19;24;29;40;18;130;148
3;9;11;17;28;30;6;98;104
12;20;25;27;32;42;2;158;160
5;7;12;19;39;44;26;126;152
3;13;15;23;29;39;14;122;136
15;16;22;25;31;32;37;141;178
2;6;23;36;40;42;45;149;194
1;13;15;24;40;45;36;138;174
11;22;24;27;30;41;2;155;157
7;18;19;30;37;38;6;149;155
7;13;17;29;37;39;25;142;167
1;3;24;32;33;45;15;138;153
13;20;23;26;41;44;40;167;207
2;4;6;15;25;45;35;97;132
5;8;11;12;26;36;6;98;104
4;9;13;22;27;39;29;114;143
2;11;18;29;32;37;36;129;165
3;7;12;21;26;36;18;105;123
4;10;23;29;30;40;12;136;148
5;10;11;23;26;38;20;113;133
3;4;19;37;38;45;41;146;187
13;23;30;37;43;45;16;191;207
1;7;20;24;39;40;42;131;173
8;12;14;17;34;36;45;121;166
1;4;20;31;34;43;5;133;138
9;13;15;21;23;38;39;119;158
6;12;18;34;42;44;17;156;173
1;23;32;40;43;44;31;183;214
1;8;15;24;27;38;23;113;136
10;21;29;38;42;44;11;184;195
4;8;9;20;21;45;24;107;131
5;11;18;22;27;28;8;111;119
1;11;23;35;39;43;31;152;183
2;3;10;18;30;34;12;97;109
5;13;31;36;42;43;37;170;207
10;11;24;32;34;44;8;155;163
2;5;7;13;20;34;45;81;126
3;12;25;39;41;44;36;164;200
7;13;16;23;26;39;10;124;134
7;17;18;29;35;44;22;150;172
11;12;18;21;32;33;7;127;134
7;9;10;11;22;37;33;96;129
26;27;36;38;40;43;22;210;232
19;24;28;29;30;39;14;169;183
4;7;17;20;30;33;27;111;138
7;12;23;33;34;37;30;146;176
11;27;35;37;44;45;1;199;200
3;9;19;31;33;34;17;129;146
16;18;23;33;36;40;13;166;179
6;21;26;27;31;45;9;156;165
2;16;20;24;26;38;23;126;149
11;20;21;28;38;39;31;157;188
7;8;28;34;37;44;32;158;190
6;17;33;39;40;41;42;176;218
7;19;28;30;35;40;39;159;198
2;3;13;15;30;40;42;103;145
9;14;19;24;29;36;6;131;137
12;19;20;34;39;41;26;165;191
3;25;30;33;37;41;18;169;187
10;17;26;28;36;41;14;158;172
6;13;24;33;34;38;9;148;157
9;11;16;29;42;44;22;151;173
2;7;9;12;32;34;33;96;129
14;24;26;40;41;45;30;190;220
2;6;7;9;21;39;45;84;129
4;5;6;15;35;42;21;107;128
2;8;11;29;36;41;5;127;132
13;20;24;28;34;41;4;160;164
1;24;26;27;32;33;35;143;178
1;19;24;27;35;39;10;145;155
9;18;22;26;27;39;33;141;174
2;9;10;22;32;34;36;109;145
7;13;15;36;37;39;21;147;168
2;3;7;9;21;27;40;69;109
2;10;16;18;36;41;5;123;128
10;22;23;34;36;37;4;162;166
10;15;17;21;40;44;11;147;158
4;15;17;22;27;41;18;126;144
23;25;26;27;30;32;7;163;170
7;8;24;30;36;44;3;149;152
3;10;11;22;36;42;17;124;141
3;4;13;29;34;36;24;119;143
2;8;18;23;37;38;21;126;147
2;15;18;35;38;40;4;148;152
11;21;22;24;34;41;36;153;189
4;13;16;19;30;45;35;127;162
6;9;18;24;30;41;14;128;142
2;13;24;29;32;42;44;142;186
1;2;10;15;32;34;4;94;98
5;14;20;32;39;42;9;152;161
1;9;15;20;24;25;28;94;122
3;7;15;21;29;38;28;113;141
5;14;16;18;24;26;17;103;120
10;15;36;37;42;44;5;184;189
9;10;18;23;31;40;19;131;150
4;17;22;35;38;39;5;155;160
10;11;23;30;32;34;15;140;155
1;5;7;32;38;44;36;127;163
3;10;16;20;30;43;2;122;124
2;8;11;24;34;38;10;117;127
4;8;20;40;42;44;18;158;176
3;5;7;21;30;42;45;108;153
9;13;15;25;38;44;1;144;145
15;16;18;26;37;40;5;152;157
4;6;20;21;24;33;1;108;109
7;21;27;29;30;32;36;146;182
12;22;35;38;41;45;24;193;217
3;4;9;16;17;22;12;71;83
4;10;18;27;29;30;7;118;125
11;14;17;19;29;40;1;130;131
3;10;19;20;23;39;22;114;136
3;17;19;23;37;45;16;144;160
9;12;15;17;31;39;34;123;157
2;3;21;28;31;34;4;119;123
9;13;16;17;18;32;42;105;147
2;7;9;13;22;36;34;89;123
5;9;26;29;36;44;21;149;170
2;14;17;27;34;36;38;130;168
3;6;19;20;28;29;8;105;113
14;19;20;32;35;41;28;161;189
3;6;17;25;40;44;10;135;145
21;23;28;31;36;39;18;178;196
13;14;16;28;35;44;31;150;181
20;22;26;33;40;45;17;186;203
6;8;12;18;22;40;33;106;139
11;14;27;31;37;45;20;165;185
7;32;33;34;42;43;5;191;196
2;6;15;17;31;35;22;106;128
4;10;18;32;40;42;9;146;155
14;24;25;35;38;44;15;180;195
4;11;22;25;36;44;32;142;174
1;3;4;8;16;39;18;71;89
10;13;24;25;37;45;44;154;198
8;9;17;18;26;36;14;114;128
7;18;19;34;40;41;25;159;184
12;13;14;22;24;45;3;130;133
2;12;14;34;35;45;21;142;163
4;5;6;8;13;39;3;75;78
2;3;4;20;21;30;43;80;123
26;27;28;35;39;45;10;200;210
3;8;16;29;33;38;11;127;138
10;15;16;22;28;32;5;123;128
5;11;17;24;27;42;33;126;159
3;5;26;27;39;40;24;140;164
4;10;22;23;28;32;27;119;146
13;15;18;20;26;32;25;124;149
3;4;6;20;32;44;7;109;116
3;9;15;28;32;42;22;129;151
4;7;27;35;37;41;44;151;195
2;7;15;29;33;37;23;123;146
8;11;15;18;19;29;31;100;131
27;29;33;35;38;45;17;207;224
16;17;27;30;32;35;2;157;159
17;28;32;37;38;44;22;196;218
3;7;21;38;42;45;17;156;173
10;22;32;33;39;42;44;178;222
13;16;31;36;37;44;30;177;207
10;18;26;27;28;41;12;150;162
7;8;23;26;29;44;45;137;182
7;24;26;31;36;40;41;164;205
11;21;22;28;36;45;16;163;179
9;17;21;28;31;41;24;147;171
7;12;27;32;37;41;21;156;177
8;10;24;26;41;44;12;153;165
4;10;16;18;21;43;39;112;151
6;13;24;32;37;41;35;153;188
1;10;18;19;26;38;14;112;126
3;9;24;30;32;41;38;139;177
12;28;38;40;44;45;24;207;231
1;9;20;21;38;41;14;130;144
5;11;16;21;30;37;26;120;146
13;15;17;22;31;42;5;140;145
8;12;21;28;42;45;39;156;195
12;20;22;27;30;32;42;143;185
13;24;25;30;43;44;34;179;213
5;15;18;20;23;26;43;107;150
1;3;15;25;27;30;5;101;106
1;3;9;12;29;36;31;90;121
11;13;27;32;43;44;45;170;215
2;31;36;37;39;44;28;189;217
9;20;29;32;37;43;21;170;191
2;6;14;18;24;33;9;97;106
5;7;13;18;27;36;29;106;135
1;2;6;17;35;45;42;106;148
4;5;9;33;35;41;23;127;150
5;8;19;24;26;29;38;111;149
11;14;15;20;38;40;18;138;156
12;13;14;21;39;43;19;142;161
8;9;15;25;28;38;12;123;135
6;20;27;29;44;45;5;171;176
10;11;23;31;34;40;12;149;161
1;9;15;19;23;32;44;99;143
6;10;33;38;39;45;14;171;185
5;9;13;19;20;35;10;101;111
4;6;11;12;35;44;13;112;125
3;4;22;30;33;41;21;133;154
3;5;7;16;37;39;42;107;149
5;9;19;35;36;43;16;147;163
2;9;11;14;32;39;5;107;112
1;12;14;37;38;40;5;142;147
7;15;28;32;37;44;30;163;193
3;18;28;31;35;41;29;156;185
4;15;17;18;22;31;30;107;137
12;20;28;34;38;42;24;174;198
1;2;7;31;36;45;13;122;135
9;12;14;20;42;44;27;141;168
6;12;23;29;41;45;33;156;189
4;5;23;31;35;38;36;136;172
5;6;9;17;19;23;33;79;112
11;15;18;36;38;40;28;158;186
15;23;31;32;36;39;44;176;220
13;16;34;38;40;41;24;182;206
13;14;17;19;23;42;8;128;136
3;12;15;16;28;43;4;117;121
1;2;19;27;32;34;40;115;155
7;9;15;20;28;35;21;114;135
14;19;20;21;28;36;43;138;181
7;23;25;30;36;42;21;163;184
1;3;17;21;30;42;29;114;143
3;4;23;29;36;39;28;134;162
9;10;13;33;37;45;28;147;175
8;12;20;22;32;44;2;138;140
1;2;12;13;15;34;40;77;117
9;20;21;27;38;39;34;154;188
13;19;20;26;36;39;4;153;157
7;8;9;18;21;27;19;90;109
2;12;24;38;39;45;5;160;165
8;17;30;33;36;43;42;167;209
1;8;12;17;18;22;6;78;84
2;9;13;16;23;38;28;101;129
13;18;26;27;30;39;40;153;193
6;15;35;38;43;45;9;182;191
1;15;20;30;34;43;11;143;154
13;22;25;29;31;45;41;165;206
1;14;19;21;29;40;9;124;133
4;15;19;20;23;40;29;121;150
1;8;16;24;25;44;10;118;128
1;3;13;14;30;31;24;92;116
3;4;5;26;32;37;9;107;116
23;30;32;36;39;40;34;200;234
8;20;25;27;28;33;35;141;176
2;12;19;31;40;45;5;149;154
2;4;6;13;26;31;16;82;98
2;6;16;17;29;41;28;111;139
6;7;12;19;21;24;2;89;91
6;11;19;35;36;38;42;145;187
4;8;16;27;32;38;30;125;155
4;12;26;27;29;37;38;135;173
9;25;26;31;33;41;42;165;207
4;7;13;15;26;28;19;93;112
3;7;8;22;39;42;23;121;144
2;4;13;23;36;42;33;120;153
1;18;19;23;39;42;32;142;174
4;9;13;26;32;45;28;129;157
4;11;17;33;40;42;2;147;149
7;8;15;17;29;35;32;111;143
11;28;30;34;39;44;22;186;208
6;10;28;30;35;40;13;149;162
2;3;10;13;28;34;32;90;122
10;21;24;27;29;39;7;150;157
3;10;21;32;39;44;31;149;180
21;25;27;33;35;42;30;183;213
4;7;16;17;26;39;14;109;123
3;5;8;13;29;45;20;103;123
3;5;21;31;32;43;4;135;139
6;26;27;32;44;45;41;180;221
3;9;10;17;35;39;31;113;144
11;22;23;25;36;44;1;161;162
13;21;25;32;33;40;11;164;175
3;21;23;29;30;45;8;151;159
2;11;18;37;40;45;4;153;157
1;5;7;10;42;44;35;109;144
12;23;27;28;39;44;2;173;175
3;22;29;32;33;43;19;162;181
4;10;21;26;31;36;33;128;161
2;7;10;27;44;45;24;135;159
7;16;17;36;39;44;5;159;164
7;23;24;31;32;42;10;159;169
24;27;28;33;35;36;15;183;198
1;3;8;26;31;39;29;108;137
4;5;11;12;19;40;10;91;101
6;8;9;13;22;33;31;91;122
2;5;6;9;30;37;28;89;117
2;16;23;33;38;41;37;153;190
3;4;30;40;42;43;29;162;191
16;17;21;31;35;36;18;156;174
3;12;25;28;35;45;30;148;178
3;12;17;18;27;39;16;116;132
1;2;12;22;36;43;39;116;155
8;17;27;35;38;44;7;169;176
7;15;27;28;34;40;25;151;176
4;12;20;33;40;44;23;153;176
2;3;5;8;22;42;15;82;97
1;5;13;19;36;42;24;116;140
12;13;19;21;28;31;22;124;146
14;15;27;37;38;39;22;170;192
4;8;10;18;22;27;40;89;129
27;29;30;33;40;43;36;202;238
10;21;25;33;38;41;14;168;182
2;4;11;18;38;42;5;115;120
2;15;18;29;38;45;44;147;191
9;18;20;21;34;45;42;147;189
13;17;23;24;28;43;8;148;156
2;23;24;30;31;37;4;147;151
13;17;18;24;31;45;43;148;191
23;26;28;37;39;40;15;193;208
5;22;24;29;34;38;39;152;191
10;16;18;36;44;45;43;169;212
5;13;22;27;35;39;43;141;184
1;2;8;11;24;26;25;72;97
15;17;22;25;38;39;10;156;166
4;7;13;26;34;42;27;126;153
8;14;28;29;32;37;18;148;166
2;17;21;26;32;40;27;138;165
4;10;19;26;28;39;3;126;129
7;12;15;21;31;35;6;121;127
1;5;13;20;21;37;23;97;120
5;6;13;31;39;43;17;137;154
8;11;19;26;33;36;10;133;143
6;10;12;19;29;45;25;121;146
1;12;16;19;21;27;24;96;120
11;17;20;35;36;44;4;163;167
2;5;9;12;37;45;31;110;141
19;23;24;25;38;39;32;168;200
1;3;6;13;18;38;11;79;90
2;14;15;20;27;40;23;118;141
5;8;17;20;23;26;14;99;113
13;16;20;34;40;43;14;166;180
2;6;13;37;39;41;35;138;173
5;18;30;36;37;38;41;164;205
12;18;22;25;26;29;4;132;136
1;4;15;17;21;41;13;99;112
1;14;15;16;27;36;19;109;128
5;15;31;33;37;40;16;161;177
1;6;21;23;25;33;26;109;135
1;16;22;28;29;43;33;139;172
8;25;27;31;33;38;12;162;174
5;32;36;38;39;44;29;194;223
4;9;28;35;37;38;11;151;162
9;10;14;27;29;41;38;130;168
1;6;11;23;24;37;4;102;106
3;6;20;24;38;44;34;135;169
6;17;24;26;36;44;37;153;190
4;13;29;32;35;37;20;150;170
5;27;28;34;44;45;26;183;209
1;7;17;37;44;45;34;151;185
2;3;19;26;31;37;5;118;123
1;10;11;19;26;42;34;109;143
9;10;22;27;32;34;11;134;145
11;17;28;30;41;43;13;170;183
3;15;22;35;37;41;5;153;158
16;18;28;32;37;39;1;170;171
5;14;19;22;41;44;25;145;170
8;13;16;23;30;44;2;134;136
7;13;23;33;37;43;8;156;164
1;6;8;22;34;44;27;115;142
5;11;25;28;30;34;27;133;160
6;9;20;33;36;39;17;143;160
8;19;21;23;32;43;33;146;179
5;6;7;10;14;31;22;73;95
4;13;14;21;24;29;10;105;115
1;3;16;22;28;29;30;99;129
1;10;14;23;33;39;40;120;160
7;15;24;36;39;44;26;165;191
2;19;22;27;31;40;35;141;176
3;8;13;18;39;41;14;122;136
3;10;11;12;22;29;19;87;106
1;3;11;27;35;38;21;115;136
12;13;23;30;41;45;28;164;192
2;3;19;22;30;37;21;113;134
8;11;23;25;40;44;29;151;180
17;19;23;33;40;41;13;173;186
5;20;26;30;31;39;40;151;191
2;3;12;20;23;35;26;95;121
12;16;24;25;27;42;44;146;190
2;6;7;13;39;43;3;110;113
15;26;29;33;34;35;8;172;180
10;12;22;25;31;42;11;142;153
14;18;25;30;32;45;41;164;205
16;22;32;34;36;42;39;182;221
2;8;17;35;37;41;25;140;165
5;25;33;35;36;44;45;178;223
3;5;8;11;32;42;2;101;103
6;8;10;11;21;38;28;94;122
2;5;11;38;39;44;23;139;162
9;12;22;27;31;43;19;144;163
1;14;16;35;38;40;32;144;176
1;4;14;20;28;38;21;105;126
1;3;21;23;37;38;33;123;156
13;14;15;34;35;42;18;153;171
8;12;17;36;40;41;15;154;169
13;17;19;29;36;43;12;157;169
2;3;4;14;15;24;13;62;75
18;26;29;31;36;37;41;177;218
11;13;19;23;41;44;24;151;175
2;11;13;15;22;40;36;103;139
3;15;19;23;29;38;9;127;136
5;12;23;24;26;32;7;122;129
6;15;27;35;36;43;5;162;167
6;9;21;28;35;44;1;143;144
14;15;21;31;32;42;36;155;191
3;15;17;28;37;42;38;142;180
9;16;17;18;32;35;6;127;133
5;10;11;26;31;41;44;124;168
1;20;21;35;39;41;36;157;193
13;17;29;31;34;39;2;163;165
27;30;35;39;42;45;44;218;262
9;16;21;24;28;40;44;138;182
6;20;26;27;34;45;9;158;167
1;8;9;29;39;43;23;129;152
3;6;14;18;28;32;24;101;125
1;4;32;34;36;37;2;144;146
3;5;15;20;38;42;1;123;124
4;7;21;24;31;43;15;130;145
4;10;38;41;42;44;2;179;181
5;9;11;12;19;39;38;95;133
15;18;30;32;43;45;10;183;193
10;13;31;36;39;40;1;169;170
3;5;12;41;42;44;33;147;180
6;14;15;19;31;37;4;122;126
2;5;8;9;26;35;16;85;101
6;18;23;32;39;42;26;160;186
6;11;23;32;38;41;37;151;188
8;16;20;22;32;34;4;132;136
5;8;19;21;27;40;22;120;142
16;17;20;28;31;35;4;147;151
5;7;13;16;33;40;32;114;146
11;13;26;28;38;41;3;157;160
14;19;29;32;36;39;18;169;187
1;13;23;24;28;37;32;126;158
3;5;7;18;23;39;11;95;106
17;20;27;30;31;39;29;164;193
1;5;7;9;19;32;3;73;76
7;8;13;14;25;34;32;101;133
1;4;6;19;33;38;18;101;119
5;8;15;28;30;39;4;125;129
12;15;17;30;39;40;10;153;163
2;3;5;16;17;28;8;71;79
2;9;12;35;38;39;13;135;148
1;4;13;14;21;28;42;81;123
4;7;17;32;33;39;29;132;161
9;10;13;27;30;32;36;121;157
10;26;34;35;37;40;1;182;183
10;22;28;31;34;41;27;166;193
6;12;26;30;34;41;42;149;191
2;4;12;13;27;35;20;93;113
2;4;6;18;28;40;7;98;105
2;4;9;12;24;41;17;92;109
3;17;25;26;28;32;18;131;149
7;20;22;28;31;36;26;144;170
2;16;27;35;38;39;22;157;179
11;29;33;38;40;42;36;193;229
3;8;28;35;38;42;31;154;185
6;7;10;29;30;42;11;124;135
4;9;10;20;23;34;11;100;111
2;4;16;20;39;42;31;123;154
2;10;15;33;35;38;42;133;175
11;12;19;28;37;39;40;146;186
9;18;27;34;36;38;35;162;197
7;17;19;22;23;33;34;121;155
3;7;16;22;29;36;25;113;138
6;13;19;20;25;33;38;116;154
1;4;17;19;23;27;24;91;115
20;23;28;35;37;40;8;183;191
1;3;9;19;24;30;39;86;125
1;2;18;30;33;41;9;125;134
6;7;12;24;32;34;41;115;156
4;11;14;17;29;31;1;106;107
15;18;22;24;30;37;25;146;171
21;23;26;29;34;36;35;169;204
9;12;14;27;29;34;5;125;130
5;9;18;19;28;32;34;111;145
3;10;19;27;28;36;38;123;161
5;8;14;15;30;39;27;111;138
1;19;20;24;34;41;13;139;152
2;11;23;25;27;30;34;118;152
2;21;33;36;37;39;22;168;190
8;10;14;19;24;34;36;109;145
2;8;10;14;16;39;30;89;119
2;9;12;28;36;42;3;129;132
14;17;19;23;28;33;18;134;152
12;15;16;34;39;40;5;156;161
12;16;18;25;34;40;41;145;186
15;19;20;22;28;30;25;134;159
2;12;15;24;31;33;14;117;131
3;5;7;8;9;10;34;42;76
8;13;16;23;33;41;10;134;144
5;6;17;20;28;42;33;118;151
8;20;21;24;28;40;39;141;180
3;11;17;32;38;41;29;142;171
1;9;26;27;29;32;30;124;154
1;15;24;25;27;28;20;120;140
3;6;9;12;21;24;17;75;92
10;12;22;23;30;42;9;139;148
4;11;16;19;24;42;9;116;125
10;13;24;25;36;41;8;149;157
8;13;14;18;25;38;19;116;135
1;14;28;29;32;39;3;143;146
13;16;28;35;36;38;6;166;172
1;9;13;27;36;38;6;124;130
6;8;10;11;14;18;4;67;71
12;20;24;30;39;41;38;166;204
7;21;23;31;32;39;34;153;187
3;6;15;22;26;36;20;108;128
2;6;10;22;27;30;9;97;106
2;3;10;12;14;19;20;60;80
1;7;8;28;32;41;5;117;122
19;20;28;29;31;36;10;163;173
11;19;25;33;34;42;28;164;192
1;3;11;18;27;38;40;98;138
2;14;19;21;35;38;37;129;166
11;13;18;35;39;40;20;156;176
9;13;35;36;37;41;4;171;175
4;9;24;25;28;36;1;126;127
15;26;30;31;37;38;36;177;213
2;5;9;16;18;41;3;91;94
3;6;27;30;31;36;40;133;173
1;2;12;28;39;41;15;123;138
6;8;21;24;29;34;13;122;135
4;8;15;16;23;24;19;90;109
13;18;24;28;34;38;15;155;170
7;11;15;30;35;38;9;136;145
10;13;20;38;40;42;22;163;185
8;9;19;32;37;39;35;144;179
10;12;14;21;40;41;7;138;145
2;3;12;19;26;32;27;94;121
7;12;23;25;28;39;4;134;138
5;8;11;29;33;34;9;120;129
8;18;20;25;28;40;2;139;141
3;13;20;23;25;38;40;122;162
3;5;19;24;29;31;7;111;118
8;11;23;37;39;42;26;160;186
14;15;22;28;30;35;9;144;153
3;8;25;31;37;42;38;146;184
4;7;10;12;13;41;14;87;101
4;12;25;33;35;41;26;150;176
2;6;10;18;39;42;14;117;131
1;11;14;26;37;38;13;127;140
2;19;21;32;34;40;33;148;181
3;9;13;25;36;41;6;127;133
13;14;17;25;27;33;2;129;131
3;7;11;20;32;39;13;112;125
12;34;35;38;41;42;32;202;234
1;3;16;17;28;42;26;107;133
15;26;33;36;37;38;4;185;189
1;15;18;28;30;38;21;130;151
1;10;11;28;34;41;21;125;146
7;8;9;10;19;21;6;74;80
1;6;11;26;30;39;15;113;128
12;14;16;26;35;40;24;143;167
4;25;30;33;34;41;13;167;180
1;4;7;22;37;38;32;109;141
3;4;8;12;27;36;14;90;104
1;3;7;16;27;36;4;90;94
10;11;22;31;37;38;41;149;190
3;11;14;26;32;35;2;121;123
4;12;13;22;37;39;1;127;128
3;8;11;21;27;34;14;104;118
10;11;13;17;34;41;38;126;164
13;14;24;27;35;36;21;149;170
6;17;21;25;33;36;32;138;170
3;12;13;20;31;40;39;119;158
1;8;12;23;31;40;21;115;136
1;3;10;15;22;27;12;78;90
5;8;9;11;22;36;27;91;118
5;22;29;32;36;37;16;161;177
1;7;9;29;31;39;18;116;134
1;7;14;23;24;40;4;109;113
20;21;23;28;34;36;11;162;173
6;14;24;28;31;38;22;141;163
1;2;6;16;19;21;40;65;105
2;4;7;22;30;37;32;102;134
2;5;17;18;20;23;11;85;96
1;4;8;22;38;39;40;112;152
11;15;22;25;26;28;32;127;159
6;11;25;31;35;38;8;146;154
21;22;30;31;36;38;3;178;181
5;13;21;33;34;38;27;144;171
11;17;21;37;38;39;9;163;172
9;19;20;24;37;38;12;147;159
3;6;14;38;39;42;19;142;161
1;3;5;20;37;41;23;107;130
7;8;12;14;21;30;4;92;96
4;12;17;36;38;40;30;147;177
10;19;30;37;39;42;31;177;208
3;5;21;23;34;35;11;121;132
9;13;16;18;23;37;14;116;130
5;7;16;20;30;42;12;120;132
1;3;6;19;24;30;40;83;123
5;13;15;16;21;31;3;101;104
8;13;14;33;36;37;31;141;172
5;16;21;26;27;42;9;137;146
5;15;23;26;27;36;38;132;170
6;15;27;30;31;39;25;148;173
6;11;12;13;25;38;15;105;120
6;9;20;25;35;41;30;136;166
9;14;16;20;34;39;32;132;164
7;14;18;22;28;42;23;131;154
5;11;17;20;29;35;9;117;126
15;21;24;28;31;39;20;158;178
2;8;9;26;30;41;1;116;117
6;22;29;35;38;41;2;171;173
4;17;26;27;33;39;25;146;171
1;2;3;14;19;21;31;60;91
3;9;13;25;34;42;2;126;128
1;9;12;17;33;38;37;110;147
4;8;12;14;26;30;13;94;107
4;6;11;18;27;36;35;102;137
1;5;11;17;29;36;35;99;134
1;9;15;19;25;37;34;106;140
1;2;6;7;8;35;25;59;84
4;7;23;30;36;39;38;139;177
2;7;18;19;21;25;24;92;116
3;7;13;22;24;30;20;99;119
8;12;14;23;27;34;18;118;136
1;2;3;25;37;40;16;108;124
2;6;14;35;40;42;5;139;144
8;12;16;28;31;32;42;127;169
10;11;12;13;32;37;2;115;117
2;9;11;29;31;32;7;114;121
3;14;28;37;38;42;41;162;203
15;20;21;27;29;41;33;153;186
4;6;17;27;33;36;38;123;161
4;11;20;28;39;41;1;143;144
6;9;10;27;32;36;15;120;135
3;7;10;30;31;38;32;119;151
2;8;18;29;32;41;6;130;136
7;22;23;24;37;41;25;154;179
4;10;12;13;35;38;31;112;143
12;13;27;31;36;39;9;158;167
4;9;12;16;20;28;36;89;125
2;9;11;13;14;22;39;71;110
11;18;32;35;36;37;6;169;175
11;23;32;36;38;39;20;179;199
6;8;9;22;31;36;5;112;117
9;18;26;27;34;42;36;156;192
9;28;29;32;33;38;18;169;187
13;14;19;21;34;39;28;140;168
6;18;24;33;34;39;12;154;166
5;7;23;29;35;36;42;135;177
3;6;19;27;37;38;34;130;164
8;9;14;22;27;34;17;114;131
4;11;14;23;26;30;40;108;148
17;21;27;38;40;42;11;185;196
5;16;32;34;39;42;38;168;206
5;16;18;22;24;28;4;113;117
4;11;12;14;16;41;42;98;140
1;2;24;25;33;37;11;122;133
1;3;11;13;17;38;22;83;105
15;22;29;31;32;42;2;171;173
5;18;30;31;40;41;4;165;169
4;27;30;33;38;41;12;173;185
13;20;23;26;34;39;21;155;176
2;3;24;29;39;41;33;138;171
4;6;14;34;39;41;21;138;159
9;13;22;34;40;41;18;159;177
4;9;15;17;28;33;1;106;107
7;19;23;25;29;34;26;137;163
6;17;19;21;31;34;40;128;168
3;6;13;31;41;42;15;136;151
12;14;20;27;32;42;1;147;148
4;9;13;20;29;34;7;109;116
2;7;15;18;26;34;40;102;142
2;5;14;21;31;36;41;109;150
1;10;11;16;27;31;40;96;136
4;13;14;25;34;37;3;127;130
6;9;11;14;15;23;7;78;85
1;6;9;13;22;23;11;74;85
3;10;17;22;23;35;33;110;143
3;5;19;22;26;37;35;112;147
3;9;11;14;20;38;39;95;134
5;9;14;17;32;41;38;118;156
1;14;15;16;40;41;39;127;166
7;9;14;18;27;40;17;115;132
2;4;9;31;37;38;32;121;153
4;7;15;23;28;29;18;106;124
3;4;9;13;18;20;38;67;105
3;7;13;20;23;25;1;91;92
10;21;25;29;31;40;11;156;167
1;3;5;11;21;38;34;79;113
10;19;24;25;28;33;12;139;151
7;13;14;20;25;37;12;116;128
9;10;18;26;32;37;34;132;166
3;12;14;18;28;41;36;116;152
4;13;19;21;22;41;29;120;149
5;10;13;18;22;32;30;100;130
5;6;11;13;36;39;23;110;133
2;3;19;25;26;32;10;107;117
7;10;11;16;27;41;14;112;126
2;7;13;20;21;42;24;105;129
10;14;21;27;30;31;35;133;168
17;19;23;36;38;42;28;175;203
9;15;18;29;30;38;37;139;176
14;15;19;20;26;39;28;133;161
2;15;17;25;34;35;23;128;151
1;20;21;29;34;41;24;146;170
13;14;34;35;40;41;18;177;195
14;20;28;33;34;40;42;169;211
8;21;22;28;32;40;37;151;188
1;3;20;26;35;37;42;122;164
10;12;14;30;36;42;41;144;185
3;4;22;26;32;34;42;121;163
1;15;16;31;34;40;6;137;143
4;6;9;10;15;22;28;66;94
5;10;11;18;25;32;14;101;115
2;8;15;21;28;29;5;103;108
2;4;15;21;22;37;26;101;127
1;2;12;14;15;39;33;83;116
5;10;18;21;24;34;39;112;151
19;21;29;36;38;40;34;183;217
2;10;15;17;39;41;20;124;144
9;11;18;25;31;40;38;134;172
2;3;15;16;21;26;29;83;112
1;11;13;17;39;42;7;123;130
3;5;6;31;32;33;38;110;148
7;9;12;20;24;29;36;101;137
10;13;21;24;31;40;32;139;171
10;14;19;25;39;40;13;147;160
1;20;21;24;38;41;29;145;174
20;28;29;30;34;37;27;178;205
2;3;6;13;15;18;20;57;77
13;15;20;26;27;28;16;129;145
15;28;30;32;36;39;5;180;185
1;3;9;13;19;27;20;72;92
4;5;10;25;34;36;7;114;121
9;11;16;23;35;39;7;133;140
4;7;10;16;18;24;36;79;115
1;2;4;6;32;42;9;87;96
5;13;18;23;29;36;15;124;139
3;15;19;32;34;42;28;145;173
3;11;16;17;29;41;32;117;149
6;17;34;35;39;40;18;171;189
1;7;12;19;35;39;20;113;133
5;7;10;12;23;36;21;93;114
24;27;38;39;40;41;42;209;251
1;6;9;12;16;26;39;70;109
1;11;23;30;32;35;37;132;169
9;17;18;24;25;38;20;131;151
7;12;15;21;26;37;29;118;147
8;15;25;26;30;41;18;145;163
11;12;18;27;30;34;35;132;167
11;15;16;32;41;42;4;157;161
15;25;27;32;40;41;36;180;216
13;14;15;33;37;41;38;153;191
16;18;24;26;27;37;33;148;181
3;5;9;25;26;36;35;104;139
6;15;26;28;34;38;17;147;164
2;18;21;25;29;40;8;135;143
1;3;11;14;34;37;18;100;118
6;15;30;34;39;41;31;165;196
13;24;33;34;36;39;16;179;195
17;26;34;36;38;41;30;192;222
3;9;15;26;30;37;1;120;121
3;5;14;15;28;33;10;98;108
3;4;13;24;26;34;7;104;111
5;8;10;11;22;35;16;91;107
13;14;16;37;38;40;32;158;190
6;16;21;23;30;34;15;130;145
9;15;25;32;37;39;30;157;187
9;15;16;24;30;37;36;131;167
2;4;10;25;33;42;38;116;154
5;16;21;29;31;37;27;139;166
2;8;18;23;28;38;32;117;149
2;5;20;21;24;35;36;107;143
1;7;13;27;29;36;20;113;133
1;13;16;19;28;42;21;119;140
1;7;16;20;35;36;10;115;125
5;6;7;10;39;41;30;108;138
12;16;22;28;38;42;2;158;160
5;6;16;18;26;29;30;100;130
3;19;32;34;35;42;21;165;186
3;8;9;15;18;30;28;83;111
9;10;23;24;34;35;13;135;148
2;13;14;19;20;36;26;104;130
3;10;11;17;22;32;28;95;123
4;15;18;21;24;42;40;124;164
3;7;10;12;15;34;40;81;121
6;10;15;25;30;39;33;125;158
1;4;13;19;20;25;22;82;104
11;21;23;29;32;33;8;149;157
13;14;16;29;33;41;8;146;154
5;6;11;15;25;34;41;96;137
1;5;15;28;33;41;19;123;142
2;4;8;16;28;31;21;89;110
6;10;18;23;36;38;14;131;145
7;9;30;32;35;42;4;155;159
5;20;23;28;29;33;13;138;151
3;10;19;24;27;28;30;111;141
1;20;21;24;28;39;34;133;167
6;13;15;24;31;34;28;123;151
2;4;6;7;20;35;39;74;113
2;4;14;16;19;25;33;80;113
2;7;13;21;23;40;35;106;141
3;4;32;39;40;42;25;160;185
5;13;14;16;20;33;3;101;104
3;4;14;22;34;37;32;114;146
3;7;9;14;16;42;29;91;120
2;4;16;22;34;40;6;118;124
1;2;4;10;34;40;37;91;128
7;21;26;28;33;37;5;152;157
7;9;19;27;35;36;28;133;161
3;15;16;21;27;28;23;110;133
2;23;28;30;32;36;40;151;191
9;11;13;22;24;29;6;108;114
5;16;21;23;34;39;4;138;142
3;6;15;22;29;31;21;106;127
5;12;14;18;31;33;3;113;116
6;18;20;28;37;40;36;149;185
3;25;32;33;37;38;31;168;199
22;23;26;27;34;37;3;169;172
3;5;14;22;30;32;4;106;110
6;7;9;10;14;15;1;61;62
6;9;13;14;18;37;33;97;130
12;15;22;24;32;37;35;142;177
4;14;22;26;31;35;28;132;160
12;16;18;21;25;38;31;130;161
1;2;14;20;32;39;28;108;136
7;21;25;30;31;40;28;154;182
1;11;15;23;27;38;30;115;145
1;14;15;17;32;41;38;120;158
4;12;16;24;38;39;6;133;139
2;3;11;23;27;39;32;105;137
2;3;10;24;29;40;16;108;124
1;7;8;11;12;19;22;58;80
2;3;22;35;36;40;19;138;157
5;11;16;28;30;39;2;129;131
3;17;20;34;36;40;7;150;157
2;5;10;15;35;38;42;105;147
13;21;25;28;33;35;17;155;172
4;12;13;14;31;35;9;109;118
7;8;10;22;23;32;13;102;115
1;8;11;14;34;39;2;107;109
3;16;18;23;32;39;38;131;169
1;6;11;14;30;36;20;98;118
4;7;16;18;32;38;17;115;132
1;4;19;20;34;42;29;120;149
1;12;13;18;29;37;26;110;136
6;10;11;16;21;32;5;96;101
2;4;6;14;21;29;22;76;98
1;5;7;20;26;37;14;96;110
15;16;18;38;40;42;28;169;197
2;9;21;23;36;41;7;132;139
10;14;19;25;36;42;41;146;187
11;20;23;28;33;37;32;152;184
1;6;7;8;9;27;11;58;69
5;22;29;32;33;41;6;162;168
7;18;26;29;33;37;22;150;172
2;3;4;11;16;21;12;57;69
10;17;20;22;24;25;6;118;124
6;16;30;32;33;42;1;159;160
4;6;18;31;39;42;36;140;176
2;13;14;17;36;40;23;122;145
1;11;21;22;40;42;36;137;173
5;10;20;31;37;39;26;142;168
3;4;7;8;16;19;20;57;77
6;8;15;31;35;41;20;136;156
10;12;26;31;38;42;37;159;196
2;8;17;22;34;35;28;118;146
1;6;14;16;19;32;13;88;101
12;16;20;22;27;29;3;126;129
1;5;11;17;19;30;15;83;98
7;10;12;19;28;40;41;116;157
2;6;8;10;12;22;24;60;84
8;14;19;23;27;39;41;130;171
5;9;11;18;22;23;10;88;98
1;7;21;22;26;39;4;116;120
3;5;8;31;36;40;2;123;125
7;16;23;32;35;40;31;153;184
1;9;28;31;32;39;3;140;143
14;15;31;38;39;41;13;178;191
4;19;22;27;36;39;1;147;148
5;6;7;21;32;40;16;111;127
15;16;17;18;34;42;12;142;154
2;3;8;18;30;32;7;93;100
11;14;28;31;38;42;32;164;196
2;10;16;32;33;40;20;133;153
10;14;23;35;36;42;22;160;182
4;5;27;29;35;42;14;142;156
2;22;27;29;35;36;18;151;169
5;8;14;22;28;41;36;118;154
2;3;4;5;30;34;12;78;90
1;13;15;18;31;32;14;110;124
7;8;10;28;39;42;41;134;175
5;9;16;17;20;29;41;96;137
1;13;14;15;32;39;27;114;141
3;7;19;21;22;35;26;107;133
7;8;9;19;37;40;17;120;137
1;7;12;15;25;32;23;92;115
5;9;10;12;31;39;38;106;144
4;7;9;25;30;37;32;112;144
4;11;14;20;22;41;17;112;129
2;7;9;14;22;40;34;94;128
2;4;8;17;26;32;14;89;103
4;12;16;29;40;42;26;143;169
4;9;25;29;35;38;41;140;181
6;12;18;31;36;41;17;144;161
13;15;16;25;27;40;24;136;160
10;15;23;24;27;38;14;137;151
18;23;24;33;36;42;34;176;210
4;15;17;27;29;32;33;124;157
4;10;26;27;32;38;8;137;145
5;10;26;27;32;35;28;135;163
4;8;13;18;26;40;1;109;110
1;7;23;29;38;40;18;138;156
13;14;22;24;34;38;6;145;151
4;10;14;22;24;42;2;116;118
2;4;14;33;40;42;29;135;164
11;16;17;28;33;40;12;145;157
2;8;9;15;32;39;13;105;118
1;7;13;24;32;34;17;111;128
4;15;20;30;38;42;13;149;162
2;29;32;40;41;42;20;186;206
8;10;20;21;30;42;7;131;138
13;21;29;32;35;36;20;166;186
1;11;17;24;36;38;20;127;147
7;11;18;26;34;37;21;133;154
1;3;5;18;22;38;40;87;127
1;4;28;33;34;35;12;135;147
2;15;23;29;33;40;24;142;166
2;4;7;14;15;35;24;77;101
5;8;9;24;36;37;18;119;137
6;15;24;30;31;33;3;139;142
21;24;25;30;32;39;36;171;207
7;8;10;12;34;41;39;112;151
6;14;30;32;34;42;23;158;181
9;12;16;21;30;32;2;120;122
2;4;6;8;10;27;28;57;85
17;19;24;29;30;41;6;160;166
14;19;28;32;39;41;34;173;207
12;16;19;33;34;40;27;154;181
1;2;4;16;23;40;8;86;94
7;14;18;20;23;42;16;124;140
2;6;9;12;21;30;23;80;103
2;6;9;16;18;30;28;81;109
7;12;20;21;29;42;41;131;172
5;19;32;33;38;41;13;168;181
15;21;29;30;36;38;42;169;211
8;9;21;25;32;40;33;135;168
5;8;18;19;20;41;31;111;142
4;11;15;24;34;38;27;126;153
7;20;21;32;38;39;31;157;188
16;18;24;34;38;42;27;172;199
7;20;22;29;36;40;3;154;157
1;5;11;19;22;33;30;91;121
17;29;30;31;34;39;14;180;194
3;9;10;21;24;27;32;94;126
7;11;14;19;25;42;33;118;151
1;6;9;28;29;34;11;107;118
11;15;28;31;32;41;24;158;182
3;5;7;9;10;17;27;51;78
9;10;13;20;26;30;8;108;116
8;10;22;25;27;35;40;127;167
6;14;21;25;39;40;1;145;146
13;18;22;26;38;42;39;159;198
3;28;32;36;38;40;20;177;197
6;9;10;31;35;40;26;131;157
2;6;16;21;22;38;24;105;129
5;9;13;14;16;42;8;99;107
17;18;20;26;27;35;13;143;156
5;7;11;20;28;40;9;111;120
12;13;18;22;29;31;4;125;129
11;18;20;22;25;30;29;126;155
11;12;20;35;37;38;19;153;172
5;14;15;28;29;33;22;124;146
20;21;27;31;34;42;15;175;190
3;16;18;20;39;42;12;138;150
14;19;28;33;36;39;13;169;182
2;15;18;30;31;41;7;137;144
1;18;27;31;33;34;24;144;168
12;14;16;19;27;33;7;121;128
9;10;13;16;22;26;29;96;125
2;10;25;31;34;42;16;144;160
5;13;29;33;35;39;22;154;176
2;6;8;20;24;32;16;92;108
1;10;19;22;25;28;32;105;137
5;8;11;14;30;36;22;104;126
6;17;19;22;33;37;32;134;166
2;7;13;15;27;34;4;98;102
7;8;17;20;27;41;28;120;148
9;25;27;29;31;36;8;157;165
4;15;16;17;26;36;29;114;143
3;7;10;22;25;31;32;98;130
2;6;11;14;18;30;9;81;90
5;9;13;23;24;29;21;103;124
11;21;22;29;33;34;24;150;174
1;11;17;19;20;36;10;104;114
1;2;19;20;28;32;23;102;125
17;20;22;24;34;39;18;156;174
5;21;27;30;35;38;16;156;172
3;8;20;31;35;38;5;135;140
3;9;17;18;31;39;10;117;127
13;16;18;20;28;36;30;131;161
9;13;22;30;38;39;40;151;191
5;14;23;26;29;41;16;138;154
1;4;19;25;31;36;3;116;119
4;10;13;32;38;42;16;139;155
1;4;19;20;25;33;38;102;140
15;29;34;38;41;42;13;199;212
7;10;23;26;36;37;15;139;154
4;23;28;29;30;42;2;156;158
2;8;15;20;21;25;40;91;131
7;9;19;27;33;37;32;132;164
1;2;18;24;31;32;23;108;131
1;13;23;28;33;38;14;136;150
12;14;22;28;29;42;19;147;166
4;5;13;26;36;42;6;126;132
1;4;11;17;18;31;23;82;105
2;13;18;31;32;34;9;130;139
2;6;19;26;27;37;34;117;151
17;19;30;31;36;40;25;173;198
1;7;14;22;34;37;42;115;157
3;6;15;24;28;37;27;113;140
10;11;32;33;34;37;21;157;178
9;12;13;19;21;42;17;116;133
6;15;28;30;34;40;31;153;184
6;11;17;30;34;40;42;138;180
10;16;20;28;30;33;12;137;149
3;6;20;25;26;39;13;119;132
2;10;19;30;32;35;37;128;165
3;11;14;23;38;41;8;130;138
6;17;23;24;25;27;20;122;142
1;14;26;28;33;40;32;142;174
9;14;16;18;19;26;21;102;123
15;21;29;31;36;38;34;170;204
1;37;38;39;41;42;17;198;215
4;9;11;34;40;42;27;140;167
6;8;9;16;22;37;32;98;130
8;11;12;16;27;36;41;110;151
2;16;17;19;33;41;20;128;148
7;9;10;27;29;31;23;113;136
1;9;19;22;30;37;26;118;144
12;14;25;26;37;38;3;152;155
7;13;25;31;33;38;39;147;186
1;2;3;4;15;27;14;52;66
13;14;18;22;33;41;5;141;146
3;5;10;16;18;28;21;80;101
1;16;17;22;38;42;14;136;150
2;12;21;31;34;41;7;141;148
14;26;30;35;37;38;23;180;203
9;22;25;28;35;41;5;160;165
6;14;21;24;26;30;34;121;155
1;7;21;35;36;37;20;137;157
9;25;38;40;41;42;21;195;216
2;14;17;21;24;35;15;113;128
8;11;16;24;30;36;21;125;146
3;4;9;13;25;40;24;94;118
3;10;21;22;28;41;14;125;139
2;11;20;27;29;36;34;125;159
2;7;12;19;28;39;24;107;131
12;13;22;24;31;41;38;143;181
3;4;10;27;39;41;5;124;129
2;3;10;16;25;38;26;94;120
8;12;13;14;22;23;32;92;124
21;22;24;33;38;39;1;177;178
2;3;12;19;30;32;14;98;112
1;6;8;23;25;35;5;98;103
8;10;15;32;35;37;12;137;149
11;19;23;32;39;41;33;165;198
3;6;11;17;26;35;22;98;120
9;11;20;24;36;42;23;142;165
8;11;16;32;33;37;30;137;167
3;4;13;14;22;25;32;81;113
13;17;20;21;26;34;11;131;142
1;7;14;18;24;31;15;95;110
6;18;21;22;32;41;42;140;182
11;12;19;20;32;33;7;127;134
6;13;18;23;35;36;21;131;152
2;20;21;23;30;32;16;128;144
6;17;18;23;34;36;35;134;169
5;15;28;31;38;42;16;159;175
2;23;30;31;33;35;14;154;168
8;11;19;37;39;40;28;154;182
4;7;14;15;22;25;29;87;116
3;16;19;22;26;29;17;115;132
1;14;21;23;32;36;20;127;147
2;16;17;21;31;34;13;121;134
6;17;32;33;40;42;18;170;188
6;11;17;25;26;36;24;121;145
2;10;11;14;36;38;32;111;143
2;20;29;40;41;42;19;174;193
6;23;27;30;37;42;41;165;206
5;16;18;21;37;42;34;139;173
3;12;17;19;35;38;9;124;133
4;12;19;21;25;41;33;122;155
4;5;12;13;19;20;17;73;90
2;15;18;25;27;37;20;124;144
2;4;8;10;12;42;41;78;119
3;15;16;20;30;31;37;115;152
8;11;16;24;30;42;31;131;162
13;26;27;30;35;40;21;171;192
5;6;17;19;25;33;3;105;108
1;7;9;21;27;30;29;95;124
7;9;12;15;20;39;30;102;132
3;17;26;30;31;34;25;141;166
1;6;12;24;28;35;13;106;119
3;7;11;14;28;37;25;100;125
22;25;26;30;40;42;2;185;187
9;18;28;32;39;41;24;167;191
10;12;34;36;38;39;11;169;180
1;2;9;24;26;29;32;91;123
1;10;12;29;39;40;28;131;159
8;15;21;27;33;39;31;143;174
10;11;17;18;27;30;5;113;118
3;9;20;27;28;31;42;118;160
1;2;8;9;27;42;23;89;112
3;4;12;18;29;40;14;106;120
4;5;10;20;31;37;9;107;116
5;7;11;13;22;28;35;86;121
14;15;16;20;33;36;26;134;160
3;6;11;21;24;39;15;104;119
1;15;19;25;29;40;8;129;137
10;12;23;29;31;40;26;145;171
4;9;11;27;31;38;12;120;132
22;24;27;32;34;40;41;179;220
1;4;16;26;32;40;14;119;133
7;8;10;25;26;39;5;115;120
6;16;19;28;31;39;36;139;175
2;14;22;25;40;41;42;144;186
5;11;12;18;25;42;27;113;140
5;12;22;28;29;36;8;132;140
4;18;23;28;32;37;29;142;171
2;11;28;31;32;35;21;139;160
9;21;25;27;28;41;2;151;153
13;18;23;24;29;40;37;147;184
3;6;9;12;18;40;39;88;127
4;24;35;37;39;42;16;181;197
5;14;17;22;30;35;16;123;139
4;9;15;17;25;42;10;112;122
3;6;8;10;18;42;16;87;103
1;3;16;30;39;41;34;130;164
13;19;20;27;39;40;36;158;194
6;10;21;27;41;42;2;147;149
2;18;25;29;30;37;36;141;177
6;18;21;24;28;30;25;127;152
4;17;28;32;33;34;13;148;161
5;8;10;12;14;28;11;77;88
13;30;36;40;41;42;1;202;203
8;9;30;33;36;40;13;156;169
4;11;17;19;38;39;5;128;133
3;5;6;32;40;42;11;128;139
9;18;23;27;31;33;15;141;156
19;20;21;22;28;42;32;152;184
3;11;18;25;32;42;40;131;171
17;30;31;32;37;42;3;189;192
2;5;21;22;24;42;20;116;136
4;10;23;28;31;39;13;135;148
1;3;18;19;24;29;30;94;124
5;8;9;16;23;27;13;88;101
8;15;18;26;32;40;30;139;169
2;3;12;17;29;36;26;99;125
6;9;11;17;30;42;20;115;135
11;17;31;33;35;40;1;167;168
4;5;13;24;28;39;27;113;140
11;17;25;29;37;40;34;159;193
18;19;22;32;35;36;24;162;186
15;18;20;22;29;38;1;142;143
11;20;23;24;27;33;8;138;146
7;10;25;32;33;35;40;142;182
13;14;16;18;26;37;33;124;157
2;4;14;28;36;42;19;126;145
8;15;17;18;19;41;22;118;140
1;6;10;29;34;41;24;121;145
2;9;22;26;32;34;29;125;154
6;8;9;10;24;36;29;93;122
6;7;9;14;19;26;37;81;118
14;15;21;32;36;41;8;159;167
9;15;16;18;21;35;13;114;127
1;3;17;18;27;41;29;107;136
7;8;21;22;30;40;20;128;148
7;10;11;29;35;39;14;131;145
10;12;14;18;20;31;23;105;128
7;10;11;17;24;32;21;101;122
8;11;13;16;19;34;23;101;124
7;19;20;27;35;41;1;149;150
3;9;23;31;33;36;29;135;164
10;15;16;31;33;42;25;147;172
3;18;19;34;41;42;5;157;162
7;13;15;34;39;42;40;150;190
5;11;12;29;34;37;9;128;137
11;22;24;30;34;38;23;159;182
2;9;18;26;34;38;14;127;141
2;4;21;34;36;39;11;136;147
2;4;14;27;34;39;11;120;131
6;16;18;26;34;38;22;138;160
6;23;32;33;34;35;18;163;181
11;16;17;28;34;41;32;147;179
6;10;11;25;26;37;14;115;129
9;11;18;30;33;39;38;140;178
5;11;12;13;24;37;1;102;103
1;6;8;25;26;27;34;93;127
1;9;12;18;19;31;42;90;132
1;10;12;19;31;40;13;113;126
2;3;4;12;20;24;5;65;70
3;13;19;26;30;36;8;127;135
2;12;18;24;25;40;15;121;136
1;14;15;31;37;39;36;137;173
7;8;11;25;30;38;29;119;148
1;5;15;25;28;37;24;111;135
2;4;17;25;27;35;21;110;131
10;15;18;24;34;36;41;137;178
2;11;24;32;35;40;17;144;161
12;14;15;32;36;42;35;151;186
3;5;7;10;16;19;11;60;71
6;7;11;13;16;33;24;86;110
7;10;12;15;16;36;4;96;100
9;17;24;26;29;38;41;143;184
7;11;13;20;36;37;21;124;145
1;5;10;14;27;35;11;92;103
14;15;19;24;28;41;31;141;172
8;19;21;28;38;40;10;154;164
3;8;10;21;30;42;35;114;149
4;9;10;15;33;42;7;113;120
8;10;12;20;27;30;29;107;136
20;32;38;39;41;42;34;212;246
12;14;21;25;27;28;33;127;160
1;3;5;16;23;28;38;76;114
6;12;19;28;35;42;13;142;155
13;15;24;26;28;42;12;148;160
11;19;23;27;36;41;42;157;199
2;4;10;27;28;33;19;104;123
7;14;19;26;32;36;15;134;149
3;6;13;18;32;34;19;106;125
3;5;10;14;19;29;38;80;118
20;23;30;31;40;41;29;185;214
1;17;20;22;27;32;3;119;122
5;10;17;20;27;33;18;112;130
2;9;11;24;27;40;14;113;127
3;16;18;33;37;40;27;147;174
8;14;17;27;28;30;37;124;161
5;14;21;28;30;37;2;135;137
4;8;9;13;19;20;24;73;97
3;20;24;25;36;40;32;148;180
7;17;19;23;25;31;34;122;156
3;5;21;26;27;41;28;123;151
2;19;23;25;39;42;9;150;159
12;16;22;23;28;36;20;137;157
7;10;14;24;37;41;11;133;144
2;11;16;21;37;40;10;127;137
11;16;19;21;28;31;12;126;138
11;18;31;33;34;35;10;162;172
1;7;14;33;35;41;24;131;155
12;16;21;23;36;41;10;149;159
4;10;18;32;33;34;23;131;154
1;2;13;15;22;31;39;84;123
7;9;12;16;37;42;18;123;141
12;21;33;36;40;41;26;183;209
9;17;22;30;36;42;20;156;176
6;13;14;22;23;24;35;102;137
4;12;24;29;32;36;39;137;176
4;8;10;22;35;37;40;116;156
4;17;26;30;31;35;28;143;171
1;5;19;32;35;36;23;128;151
5;11;17;28;29;33;40;123;163
8;16;21;30;31;40;23;146;169
3;8;10;12;14;15;27;62;89
2;3;4;15;23;35;21;82;103
8;18;21;38;39;42;30;166;196
19;22;29;32;34;36;18;172;190
10;17;21;29;31;34;5;142;147
7;9;14;32;34;37;23;133;156
10;14;22;23;35;41;27;145;172
6;13;17;18;28;38;29;120;149
4;13;17;28;30;38;19;130;149
14;21;25;26;28;37;34;151;185
7;8;18;29;34;37;12;133;145
14;21;32;37;38;41;5;183;188
1;12;13;14;39;42;24;121;145
2;10;16;21;22;25;41;96;137
5;7;21;38;39;40;20;150;170
1;7;9;28;32;36;34;113;147
15;16;26;30;31;35;36;153;189
2;15;22;32;33;38;6;142;148
8;16;18;21;24;42;7;129;136
1;3;10;22;32;35;26;103;129
7;20;21;22;25;28;4;123;127
4;8;9;19;24;37;34;101;135
4;9;15;16;29;35;37;108;145
1;6;10;23;39;41;42;120;162
9;19;20;23;27;41;13;139;152
7;13;14;17;18;23;2;92;94
4;5;6;14;31;34;11;94;105
1;9;10;34;36;39;16;129;145
5;13;21;32;34;41;16;146;162
6;10;15;19;30;41;7;121;128
1;14;17;23;26;40;24;121;145
20;21;24;27;31;36;28;159;187
1;8;20;24;37;39;31;129;160
5;6;10;21;22;37;28;101;129
11;18;19;29;36;41;16;154;170
1;7;12;15;17;21;26;73;99
6;23;27;31;32;41;18;160;178
1;16;20;23;38;39;11;137;148
6;7;10;12;36;38;32;109;141
1;8;23;24;25;37;18;118;136
9;10;19;25;36;42;37;141;178
9;15;22;24;36;41;26;147;173
1;4;15;17;27;38;25;102;127
1;9;12;14;23;31;5;90;95
2;11;13;15;27;29;41;97;138
2;3;5;16;29;41;19;96;115
6;11;14;27;32;40;15;130;145
1;7;11;18;22;25;40;84;124
12;14;20;30;39;42;41;157;198
13;16;21;23;35;39;29;147;176
9;11;18;22;24;40;8;124;132
1;7;8;11;40;42;10;109;119
9;15;17;27;41;42;1;151;152
2;3;8;22;30;42;16;107;123
6;8;22;36;37;39;5;148;153
13;16;17;29;32;39;37;146;183
8;13;20;32;33;40;31;146;177
16;27;31;33;35;39;24;181;205
9;10;12;19;37;40;41;127;168
6;8;13;16;36;40;15;119;134
2;12;13;16;18;41;1;102;103
8;15;18;22;32;35;20;130;150
6;8;19;20;21;26;35;100;135
1;2;11;17;18;19;26;68;94
2;5;13;24;28;34;17;106;123
1;11;16;17;21;40;14;106;120
4;5;6;16;25;36;41;92;133
5;7;11;15;31;41;6;110;116
12;15;19;32;34;40;4;152;156
9;13;22;28;39;42;7;153;160
2;6;14;20;23;32;33;97;130
7;11;15;16;17;33;21;99;120
5;11;18;23;24;26;35;107;142
2;6;7;23;30;32;14;100;114
13;16;25;27;29;36;31;146;177
3;9;10;17;34;41;19;114;133
3;9;11;17;25;27;36;92;128
5;9;10;15;18;32;21;89;110
3;5;9;18;28;34;14;97;111
4;18;28;29;35;41;38;155;193
1;2;11;19;22;41;10;96;106
1;6;19;37;38;39;41;140;181
5;14;19;21;26;27;31;112;143
3;19;31;32;33;39;22;157;179
4;5;25;27;39;41;3;141;144
4;16;26;31;34;35;24;146;170
1;12;16;18;20;23;38;90;128
1;13;15;25;32;40;18;126;144
1;9;18;20;23;31;27;102;129
4;6;26;30;37;38;24;141;165
9;22;25;26;28;37;2;147;149
1;6;10;13;18;23;32;71;103
7;21;23;25;34;40;12;150;162
10;12;16;21;26;36;20;121;141
5;10;16;19;27;41;9;118;127
14;20;24;27;29;35;39;149;188
5;14;16;21;24;25;30;105;135
9;16;20;25;38;40;37;148;185
10;17;27;31;32;33;11;150;161
6;9;14;30;35;40;13;134;147
8;15;29;32;39;42;9;165;174
4;11;12;31;32;40;26;130;156
3;18;22;29;33;37;24;142;166
9;10;19;24;27;41;36;130;166
4;9;13;21;30;41;42;118;160
13;14;26;28;35;36;10;152;162
1;6;22;27;36;38;9;130;139
2;3;16;19;23;26;18;89;107
2;15;23;33;37;42;19;152;171
14;22;28;36;41;42;1;183;184
3;4;9;22;25;33;20;96;116
11;14;25;26;36;38;41;150;191
5;10;22;26;28;41;17;132;149
9;19;30;31;39;41;10;169;179
9;12;16;24;31;34;23;126;149
3;6;12;25;30;32;4;108;112
2;12;15;19;20;34;39;102;141
2;8;21;28;31;35;25;125;150
6;9;21;24;39;42;27;141;168
6;21;23;24;37;39;31;150;181
9;12;15;25;26;40;3;127;130
10;12;14;19;34;38;27;127;154
6;14;15;22;28;39;24;124;148
2;19;23;25;36;38;11;143;154
4;7;11;16;21;35;33;94;127
1;7;23;26;38;42;41;137;178
8;10;15;28;32;40;9;133;142
2;10;22;27;35;42;33;138;171
3;8;13;15;33;42;7;114;121
3;6;15;25;37;41;42;127;169
12;23;32;33;35;40;18;175;193
7;9;16;17;37;40;27;126;153
7;11;17;28;29;33;9;125;134
6;8;10;18;23;42;13;107;120
9;13;22;27;30;34;35;135;170
14;15;29;31;37;39;4;165;169
12;17;22;25;31;39;3;146;149
18;20;21;30;35;40;23;164;187
5;28;29;30;34;42;3;168;171
5;14;21;29;36;42;6;147;153
4;7;19;25;29;40;22;124;146
2;4;22;31;36;39;15;134;149
14;16;19;21;24;35;5;129;134
10;14;15;22;35;38;37;134;171
14;15;17;20;30;31;40;127;167
8;15;17;27;28;37;39;132;171
8;14;22;31;37;42;30;154;184
9;19;23;25;28;42;11;146;157
1;2;8;15;24;29;31;79;110
1;4;5;23;32;35;15;100;115
1;7;10;11;27;33;28;89;117
8;9;10;12;18;26;1;83;84
2;11;16;31;35;38;19;133;152
3;9;10;32;34;35;22;123;145
17;18;28;29;33;38;31;163;194
12;17;25;26;27;40;14;147;161
1;2;21;24;27;41;11;116;127
8;20;21;24;31;32;3;136;139
1;2;11;25;26;29;37;94;131
1;8;25;33;38;40;17;145;162
8;17;18;25;36;40;4;144;148
4;5;10;12;34;42;16;107;123
6;8;15;18;36;40;7;123;130
14;17;18;26;33;40;30;148;178
4;6;20;24;38;42;33;134;167
6;7;16;19;21;25;34;94;128
6;13;16;18;24;27;32;104;136
14;15;16;27;37;41;31;150;181
1;8;17;18;33;40;2;117;119
4;22;24;34;36;39;25;159;184
3;18;19;23;27;31;25;121;146
1;3;12;13;19;37;20;85;105
9;11;18;20;21;39;29;118;147
4;15;18;22;28;38;41;125;166
12;13;29;30;34;39;22;157;179
1;6;8;13;20;42;29;90;119
12;15;19;29;34;37;11;146;157
6;9;24;25;28;42;11;134;145
17;22;23;30;34;41;5;167;172
8;12;17;20;32;39;36;128;164
1;7;10;19;23;40;9;100;109
2;5;7;24;30;39;4;107;111
9;10;22;27;35;37;25;140;165
1;19;20;29;30;41;36;140;176
4;12;33;35;39;40;5;163;168
5;8;18;28;31;34;11;124;135
5;12;19;21;25;33;36;115;151
6;15;26;30;39;40;27;156;183
11;23;24;26;30;34;18;148;166
8;28;30;35;39;42;14;182;196
4;10;11;29;35;36;20;125;145
11;14;20;25;32;36;31;138;169
4;7;19;30;32;35;28;127;155
6;11;17;33;37;41;24;145;169
15;20;21;28;32;39;12;155;167
12;25;26;31;40;42;1;176;177
3;5;21;23;31;37;35;120;155
2;8;17;20;26;41;36;114;150
6;18;20;30;31;35;17;140;157
2;12;23;30;37;38;31;142;173
1;3;8;9;15;40;4;76;80
6;7;8;11;27;33;2;92;94
4;25;26;31;34;35;12;155;167
2;18;23;29;31;40;28;143;171
4;8;11;26;27;35;19;111;130
1;9;11;14;17;29;25;81;106
3;9;12;17;28;32;16;101;117
4;9;16;20;27;39;8;115;123
4;9;15;32;33;37;23;130;153
5;8;9;10;23;25;12;80;92
1;6;7;11;16;36;23;77;100
17;18;30;35;37;40;21;177;198
3;9;17;26;28;39;1;122;123
7;13;16;21;29;41;9;127;136
24;25;27;30;32;42;12;180;192
10;13;26;27;33;42;7;151;158
8;15;26;33;35;37;34;154;188
1;11;14;20;23;25;34;94;128
12;13;26;32;33;38;4;154;158
1;2;12;13;16;18;31;62;93
3;11;12;16;29;42;21;113;134
11;22;26;28;34;41;37;162;199
15;16;24;28;33;38;22;154;176
7;11;14;27;28;37;38;124;162
7;20;23;25;35;41;36;151;187
1;3;6;11;16;24;21;61;82
6;10;19;26;32;35;1;128;129
3;15;24;35;40;42;23;159;182
10;13;18;24;35;39;21;139;160
3;11;20;25;41;42;12;142;154
11;12;15;36;38;40;24;152;176
3;10;30;32;33;41;20;149;169
1;8;24;27;36;37;30;133;163
7;23;27;34;35;42;26;168;194
2;3;6;20;24;34;16;89;105
2;5;14;27;33;38;7;119;126
19;21;23;24;26;41;42;154;196
4;8;14;16;30;38;12;110;122
3;4;5;13;19;42;17;86;103
1;3;28;31;37;39;18;139;157
1;14;18;24;25;34;28;116;144
5;13;25;26;33;41;24;143;167
5;16;22;30;41;42;38;156;194
4;7;17;28;35;41;8;132;140
3;7;22;33;35;40;25;140;165
2;15;17;22;37;41;35;134;169
9;22;24;31;35;42;32;163;195
3;15;16;28;38;42;29;142;171
1;9;11;12;21;29;31;83;114
7;19;22;25;30;33;8;136;144
11;15;21;22;26;39;5;134;139
12;20;22;24;35;36;18;149;167
6;15;16;24;30;33;22;124;146
12;14;18;25;29;39;16;137;153
9;14;31;35;37;39;26;165;191
2;18;20;27;39;40;24;146;170
7;8;16;23;30;34;9;118;127
4;17;19;25;30;41;11;136;147
2;9;10;20;41;42;23;124;147
11;13;21;33;36;41;4;155;159
1;19;25;30;32;40;39;147;186
5;22;29;37;39;40;27;172;199
5;9;18;31;34;38;16;135;151
10;18;24;27;28;37;25;144;169
10;13;14;27;32;33;37;129;166
4;17;29;31;32;39;37;152;189
7;13;14;20;30;37;17;121;138
4;5;21;33;34;40;35;137;172
1;16;17;21;26;27;34;108;142
12;16;18;19;31;36;21;132;153
2;10;18;27;31;38;1;126;127
7;10;13;21;23;36;30;110;140
3;10;15;29;34;38;41;129;170
2;20;24;35;37;38;10;156;166
8;18;19;27;33;34;13;139;152
6;13;20;25;28;34;5;126;131
4;10;20;35;38;42;18;149;167
13;14;17;18;28;29;22;119;141
2;6;14;18;30;36;12;106;118
2;14;17;20;34;39;23;126;149
4;7;9;11;21;25;15;77;92
2;19;24;31;39;40;12;155;167
2;3;13;18;22;23;4;81;85
17;24;32;34;35;42;29;184;213
9;12;14;18;20;36;3;109;112
8;12;24;25;36;38;4;143;147
1;13;20;22;32;36;18;124;142
4;5;7;16;19;20;12;71;83
8;9;18;23;35;36;2;129;131
7;21;25;35;37;38;42;163;205
7;8;18;22;29;31;14;115;129
6;8;9;23;35;37;18;118;136
8;20;23;26;35;40;33;152;185
2;7;22;29;31;37;16;128;144
10;11;15;17;18;34;32;105;137
7;11;18;30;33;42;24;141;165
4;21;23;34;36;42;8;160;168
4;6;15;18;21;26;9;90;99
4;15;18;26;30;41;7;134;141
1;10;12;13;32;42;16;110;126
6;10;13;14;25;28;41;96;137
6;16;32;34;35;37;8;160;168
7;16;29;33;38;42;22;165;187
6;7;12;21;34;37;24;117;141
3;4;9;13;19;28;17;76;93
3;21;24;28;39;41;6;156;162
8;10;13;33;35;39;25;138;163
7;12;17;18;20;32;3;106;109
11;15;16;30;33;36;17;141;158
4;7;9;12;21;42;41;95;136
1;7;8;16;32;39;40;103;143
6;17;24;28;30;32;42;137;179
1;2;10;18;32;34;11;97;108
11;22;24;34;37;39;3;167;170
5;7;8;21;25;41;28;107;135
1;5;18;28;33;40;23;125;148
5;6;11;23;25;29;10;99;109
5;7;17;31;39;40;41;139;180
4;12;13;20;37;38;16;124;140
4;9;11;18;33;40;37;115;152
4;12;17;18;23;29;9;103;112
2;7;20;24;26;33;6;112;118
1;28;31;34;37;38;36;169;205
5;19;35;37;39;41;2;176;178
6;9;12;32;37;40;23;136;159
4;21;24;27;33;41;8;150;158
1;2;3;14;25;42;7;87;94
1;5;7;9;20;36;42;78;120
14;23;30;39;40;42;22;188;210
4;7;9;10;20;30;21;80;101
10;11;23;27;30;37;13;138;151
4;9;17;23;32;41;10;126;136
16;17;21;25;26;39;2;144;146
3;4;7;15;29;37;36;95;131
4;6;11;30;33;42;23;126;149
8;13;18;28;30;38;19;135;154
15;20;22;26;29;36;41;148;189
1;8;9;13;14;33;11;78;89
3;6;12;13;27;37;25;98;123
13;14;25;27;34;42;10;155;165
26;29;30;35;39;42;4;201;205
3;23;26;33;38;40;30;163;193
3;16;22;30;31;41;39;143;182
21;24;32;34;35;36;5;182;187
1;12;26;35;37;40;10;151;161
8;15;17;21;26;42;9;129;138
3;9;20;32;35;42;19;141;160
4;18;20;25;31;38;8;136;144
2;4;19;22;24;41;14;112;126
4;11;14;30;36;38;22;133;155
13;17;23;31;35;38;39;157;196
2;4;7;13;28;34;26;88;114
3;9;18;32;36;42;33;140;173
2;7;10;23;36;40;32;118;150
1;6;16;31;36;37;2;127;129
3;7;14;15;34;38;4;111;115
1;3;16;24;26;39;14;109;123
9;16;21;26;31;37;28;140;168
7;16;19;26;28;34;24;130;154
5;15;16;21;25;27;17;109;126
7;11;26;33;35;39;27;151;178
3;12;13;23;28;32;18;111;129
4;26;27;40;41;42;6;180;186
1;5;18;19;22;25;17;90;107
2;16;21;23;31;41;32;134;166
9;11;15;34;36;38;5;143;148
14;16;17;18;21;33;35;119;154
4;11;24;29;30;36;19;134;153
1;6;16;23;25;31;20;102;122
7;10;11;15;20;38;25;101;126
7;15;17;25;26;31;11;121;132
1;3;8;22;23;36;20;93;113
4;14;18;35;36;40;41;147;188
1;3;6;11;24;40;27;85;112
15;20;21;32;36;39;7;163;170
3;16;25;32;33;39;28;148;176
4;5;14;24;29;38;19;114;133
4;6;9;16;31;42;40;108;148
12;16;24;27;34;36;10;149;159
12;16;23;34;36;41;19;162;181
11;16;24;25;28;29;35;133;168
11;20;22;23;33;39;6;148;154
9;10;11;13;22;29;41;94;135
1;24;26;29;32;37;36;149;185
14;17;28;29;35;38;3;161;164
2;25;28;29;30;41;9;155;164
20;22;26;29;31;41;23;169;192
7;12;15;24;28;37;41;123;164
1;20;32;34;35;37;27;159;186
7;22;26;36;37;40;38;168;206
1;3;7;30;37;38;12;116;128
2;8;16;30;32;42;37;130;167
4;11;13;15;24;39;12;106;118
1;8;9;15;22;36;19;91;110
2;8;26;31;32;39;40;138;178
4;6;8;14;35;37;18;104;122
7;10;15;20;35;40;1;127;128
9;11;13;17;20;42;33;112;145
2;10;11;17;21;34;36;95;131
4;5;14;16;32;41;35;112;147
2;5;12;19;23;28;33;89;122
9;24;32;37;38;39;23;179;202
5;15;21;24;27;31;14;123;137
12;16;19;20;23;26;25;116;141
1;4;9;18;32;41;24;105;129
16;17;18;23;26;34;24;134;158
3;4;8;13;21;36;22;85;107
2;7;13;14;30;32;28;98;126
5;7;13;30;32;38;18;125;143
4;8;9;13;18;30;14;82;96
4;5;20;21;25;35;9;110;119
6;9;14;34;35;39;38;137;175
5;6;13;20;38;42;28;124;152
1;22;24;31;33;41;9;152;161
6;11;19;30;37;40;26;143;169
18;22;28;34;41;42;2;185;187
5;11;18;33;37;39;2;143;145
4;9;11;14;16;17;37;71;108
1;11;19;23;24;27;17;105;122
3;4;6;7;20;23;22;63;85
1;4;11;14;21;25;13;76;89
13;14;23;26;31;34;29;141;170
14;22;25;31;34;41;4;167;171
4;6;12;24;34;35;17;115;132
6;11;22;24;33;42;39;138;177
1;16;19;35;36;37;29;144;173
7;24;31;34;35;36;20;167;187
3;8;10;31;36;39;2;127;129
7;10;21;22;24;25;17;109;126
4;11;15;17;21;41;16;109;125
2;9;10;17;27;39;11;104;115
5;17;25;31;37;40;13;155;168
6;12;23;30;34;35;5;140;145
1;2;4;10;21;35;14;73;87
4;5;10;13;33;36;12;101;113
3;5;11;27;31;37;1;114;115
16;19;25;31;32;41;30;164;194
2;3;5;6;14;34;24;64;88
3;8;12;31;33;35;22;122;144
21;24;30;31;33;42;34;181;215
12;19;28;29;35;41;31;164;195
10;19;30;32;35;40;39;166;205
5;20;27;28;29;42;40;151;191
10;15;21;27;39;42;25;154;179
4;10;17;21;29;37;9;118;127
5;7;11;17;19;34;4;93;97
16;18;20;31;33;35;38;153;191
8;14;16;28;31;33;12;130;142
7;17;19;23;25;29;1;120;121
1;12;27;30;33;36;17;139;156
19;20;24;28;29;30;15;150;165
6;11;18;29;30;31;37;125;162
2;8;11;15;26;28;38;90;128
1;2;4;18;19;21;10;65;75
18;20;22;23;27;33;19;143;162
3;7;29;30;31;39;38;139;177
4;7;10;12;18;33;19;84;103
8;9;13;16;27;30;28;103;131
11;17;18;24;26;38;16;134;150
17;20;23;27;28;36;15;151;166
10;16;17;20;24;30;15;117;132
2;7;12;18;23;32;15;94;109
3;4;5;8;24;38;13;82;95
2;13;18;29;30;34;23;126;149
21;26;28;33;34;35;18;177;195
2;9;17;22;26;29;21;105;126
7;13;15;23;25;30;17;113;130
7;13;16;19;38;39;32;132;164
8;15;16;19;24;35;38;117;155
5;8;16;21;27;32;19;109;128
1;2;9;16;32;36;6;96;102
2;11;12;25;32;33;21;115;136
5;6;9;14;17;19;31;70;101
13;17;18;22;24;34;15;128;143
15;18;19;27;30;32;29;141;170
10;21;25;27;30;39;2;152;154
1;3;4;9;10;20;28;47;75
10;18;23;28;35;39;27;153;180
8;11;15;28;34;35;13;131;144
18;20;24;32;34;39;29;167;196
1;3;8;10;26;38;18;86;104
3;5;12;19;25;38;35;102;137
4;6;10;30;31;39;26;120;146
8;12;18;27;32;36;11;133;144
1;18;19;24;26;32;28;120;148
4;7;28;34;38;39;1;150;151
4;13;22;28;32;36;26;135;161
1;5;23;27;33;39;6;128;134
5;10;15;19;35;39;16;123;139
3;8;24;29;31;35;10;130;140
4;11;19;21;28;39;16;122;138
12;15;25;29;30;32;34;143;177
10;11;13;22;23;30;21;109;130
4;7;13;30;33;39;11;126;137
7;15;19;23;24;38;4;126;130
13;14;17;23;31;35;6;133;139
9;23;25;28;34;37;31;156;187
1;7;10;24;27;36;3;105;108
2;10;18;23;31;34;15;118;133
9;15;27;30;32;34;16;147;163
9;22;27;30;31;39;37;158;195
1;16;18;21;23;26;10;105;115
7;15;19;21;25;32;6;119;125
11;13;16;23;31;39;27;133;160
3;13;16;26;31;35;2;124;126
1;4;12;15;26;37;23;95;118
1;2;4;10;13;18;23;48;71
1;18;21;26;34;36;29;136;165
20;21;32;33;35;37;17;178;195
19;24;29;33;36;37;2;178;180
22;26;33;35;36;39;13;191;204
4;20;24;27;33;36;28;144;172
4;13;15;21;24;34;11;111;122
15;20;25;27;28;36;2;151;153
1;5;8;17;30;39;25;100;125
4;7;9;25;36;37;27;118;145
12;14;21;32;36;38;11;153;164
2;3;10;16;22;26;34;79;113
6;19;26;35;37;38;21;161;182
3;17;20;21;22;39;8;122;130
1;3;19;21;22;38;36;104;140
3;7;12;14;19;20;4;75;79
1;5;20;26;29;37;4;118;122
2;12;20;21;37;39;7;131;138
3;14;26;31;34;37;8;145;153
2;3;20;37;38;39;8;139;147
5;10;12;19;25;39;2;110;112
1;2;3;17;25;32;29;80;109
13;19;20;23;35;38;17;148;165
1;2;12;15;19;36;37;85;122
2;8;22;34;35;39;29;140;169
14;15;23;30;34;35;4;151;155
1;6;16;24;27;32;30;106;136
2;7;18;21;25;27;34;100;134
8;18;21;24;34;35;22;140;162
2;9;22;28;30;33;4;124;128
4;10;14;18;24;32;2;102;104
2;5;9;12;26;31;34;85;119
3;18;24;25;34;36;27;140;167
2;11;12;15;26;32;31;98;129
1;6;8;23;28;34;10;100;110
5;20;27;29;30;37;21;148;169
17;20;22;27;28;34;16;148;164
4;6;24;25;32;33;10;124;134
3;6;8;17;19;24;39;77;116
2;7;9;34;35;37;24;124;148
5;8;11;16;17;36;14;93;107
4;21;22;26;27;34;23;134;157
9;15;16;18;21;29;19;108;127
19;25;31;36;38;39;15;188;203
1;3;5;8;12;24;27;53;80
1;4;6;11;23;38;36;83;119
1;7;13;22;23;31;16;97;113
1;14;16;21;38;39;10;129;139
2;8;17;20;27;30;10;104;114
7;12;13;20;21;36;1;109;110
3;7;11;34;35;36;16;126;142
3;10;11;19;38;39;16;120;136
2;5;27;33;34;37;12;138;150
7;15;21;23;28;35;20;129;149
4;9;26;27;33;34;38;133;171
4;7;8;17;23;35;21;94;115
5;6;10;17;27;35;33;100;133
8;11;15;25;37;39;9;135;144
10;11;12;14;25;36;39;108;147
6;11;20;21;34;39;37;131;168
17;20;24;26;30;34;5;151;156
7;14;15;16;26;29;24;107;131
4;8;26;31;33;34;2;136;138
6;9;14;15;31;37;21;112;133
21;27;30;32;34;35;19;179;198
5;24;31;33;37;39;27;169;196
7;10;22;29;30;32;9;130;139
5;10;12;16;18;26;37;87;124
2;14;15;28;31;37;27;127;154
1;5;12;21;25;27;23;91;114
1;4;5;17;27;28;16;82;98
9;13;14;21;22;25;12;104;116
3;5;7;17;24;39;1;95;96
6;7;12;35;36;39;27;135;162
3;17;26;28;35;37;33;146;179
6;10;12;13;23;33;16;97;113
7;12;18;20;30;38;25;125;150
11;15;16;19;36;37;34;134;168
18;22;26;27;30;37;33;160;193
9;10;12;17;18;21;13;87;100
1;6;7;24;28;35;34;101;135
2;24;26;30;32;34;28;148;176
1;2;7;27;32;37;17;106;123
8;24;25;26;29;37;6;149;155
9;20;23;27;29;37;34;145;179
16;23;25;27;31;38;5;160;165
1;13;22;27;31;32;25;126;151
4;10;13;31;32;39;36;129;165
8;17;26;30;32;34;23;147;170
3;9;20;21;33;37;10;123;133
8;17;18;29;30;34;31;136;167
4;6;10;18;24;33;13;95;108
2;4;7;15;29;31;27;88;115
5;19;21;25;27;30;31;127;158
5;7;19;27;32;37;34;127;161
17;20;24;31;36;37;28;165;193
17;18;29;32;36;39;8;171;179
11;12;14;17;26;38;21;118;139
13;16;21;26;27;29;25;132;157
7;8;17;30;32;36;33;130;163
9;13;25;26;27;34;2;134;136
2;14;17;22;26;34;1;115;116
19;25;34;36;38;39;28;191;219
9;10;17;26;29;30;15;121;136
2;4;5;29;30;35;8;105;113
2;3;4;5;16;18;29;48;77
13;15;16;20;31;36;34;131;165
3;27;28;29;36;38;14;161;175
11;15;24;26;30;32;2;138;140
2;3;19;28;30;35;11;117;128
3;5;9;14;30;32;29;93;122
7;10;11;12;13;37;38;90;128
1;8;10;15;34;35;12;103;115
6;10;22;25;30;38;7;131;138
1;3;12;20;26;28;14;90;104
1;3;6;9;13;28;33;60;93
1;3;13;19;26;37;31;99;130
6;9;16;33;37;38;27;139;166
4;9;10;14;15;30;16;82;98
5;9;16;24;29;31;15;114;129
